47 45
0 0 0 0 0 0 0 0 0 0 0 0 0 0 0 0 0 0 0 0 0 0 0 0 0 0 0 0 0 0 0 0 0 0 0 0 0 0 0 0 0 0 0 0 0
0 0 0 0 0 0 3 3 3 3 3 3 3 3 3 3 3 3 3 0 0 0 0 0 0 0 0 3 3 3 3 3 3 3 3 3 3 3 0 0 0 0 0 0 0
0 0 0 0 0 3 3 3 3 3 3 3 3 3 3 3 3 3 3 3 3 0 0 0 0 0 3 3 3 3 3 3 3 3 3 3 3 3 3 0 0 0 0 0 0
0 0 0 0 3 3 3 3 3 1 1 1 1 1 1 1 3 3 3 3 3 0 0 0 0 3 3 3 3 3 1 1 1 1 1 1 3 3 3 3 0 0 0 0 0
0 0 0 0 3 3 3 1 1 1 1 1 1 1 1 1 1 1 1 3 3 3 0 0 3 3 3 3 1 1 1 1 1 1 1 1 1 3 3 3 0 0 0 0 0
0 0 0 3 3 3 1 1 1 1 1 1 1 1 1 1 1 1 1 3 3 3 3 3 3 3 3 1 1 1 1 3 3 3 1 1 1 1 3 3 0 0 0 0 0
0 0 0 3 3 3 1 1 1 1 3 3 3 3 1 1 1 1 1 3 3 3 3 3 3 3 1 1 1 1 1 3 3 3 3 1 1 1 3 3 3 0 0 0 0
0 0 0 3 3 1 1 1 1 3 3 3 3 3 1 1 1 1 3 3 3 0 0 3 3 3 1 1 1 1 1 3 3 3 3 1 1 1 3 3 3 0 0 0 0
0 0 0 3 3 1 1 1 1 3 3 3 3 1 1 1 1 3 3 3 3 3 3 3 3 1 1 2 1 1 1 1 3 3 3 3 1 1 3 3 3 0 0 0 0
0 0 0 3 3 1 1 1 1 3 3 3 1 1 4 1 1 3 3 3 3 3 3 3 3 1 5 5 5 1 1 1 1 3 3 3 1 1 1 3 3 3 0 0 0
0 0 0 3 3 1 1 1 1 1 1 1 1 5 5 5 1 3 3 1 1 1 1 1 1 1 5 5 5 5 5 5 1 3 3 3 1 1 1 3 3 3 0 0 0
0 0 3 3 3 1 1 1 1 1 1 5 5 5 5 5 1 1 1 1 5 5 5 1 1 1 5 5 5 5 5 5 1 3 3 3 1 1 1 3 3 3 3 0 0
0 0 3 3 3 1 1 1 1 1 1 5 5 5 5 5 5 5 5 5 5 5 5 1 1 1 1 5 5 5 5 5 1 1 3 3 1 1 1 3 3 3 3 0 0
0 0 3 3 3 1 1 1 1 1 1 5 5 5 5 5 5 5 5 5 5 5 5 1 1 1 1 1 1 5 5 5 1 1 1 1 1 1 1 1 3 3 3 0 0
0 0 3 3 1 1 1 1 1 1 1 1 5 5 5 5 5 5 5 5 5 5 5 1 1 1 1 1 1 1 1 1 1 1 1 1 1 4 1 1 1 3 3 0 0
0 3 3 3 1 1 1 1 1 1 1 1 5 5 5 5 5 1 1 1 1 5 5 1 1 1 1 1 1 1 1 1 1 1 5 5 5 5 5 5 1 3 3 0 0
0 3 3 3 1 1 1 1 1 1 1 1 5 5 5 5 1 1 1 1 1 1 1 1 1 1 1 1 1 1 1 1 1 5 5 5 5 5 5 5 1 3 3 0 0
0 3 3 3 1 1 1 1 1 1 1 1 5 5 5 1 1 3 3 1 1 1 1 1 1 1 1 1 1 1 1 1 1 1 5 5 5 5 5 1 1 3 3 0 0
0 3 3 3 1 1 2 1 1 1 1 1 5 5 5 1 3 3 3 1 1 1 1 1 1 1 1 5 5 1 1 1 1 1 1 1 5 5 1 1 1 3 3 0 0
0 3 3 1 1 5 5 5 1 1 1 5 5 5 1 1 3 3 3 1 1 1 4 1 1 5 5 5 5 1 1 1 1 1 1 1 5 5 1 1 1 3 3 3 0
0 3 3 1 5 5 5 5 5 5 5 5 5 5 1 1 1 1 1 1 5 5 5 5 5 5 5 5 5 1 1 1 1 1 4 1 5 5 5 1 1 3 3 3 0
0 3 3 1 5 5 5 5 5 5 5 5 5 5 5 1 1 5 5 5 5 5 5 5 5 5 5 5 5 1 1 1 1 5 5 5 5 5 5 1 1 3 3 3 0
0 3 3 1 1 1 5 5 5 5 5 5 5 5 5 5 5 5 5 5 5 5 5 5 5 5 5 5 5 1 1 1 1 5 5 5 5 5 5 5 1 3 3 3 0
0 3 3 3 1 1 1 5 5 5 5 5 5 5 5 5 5 5 5 5 5 5 5 5 5 5 5 5 5 1 1 1 1 5 5 5 5 5 5 5 1 1 3 3 0
0 3 3 3 3 1 1 1 1 5 5 5 5 5 5 5 5 5 5 5 5 5 5 5 5 5 5 5 1 1 1 1 1 5 5 5 5 5 5 5 5 1 3 3 0
0 0 3 3 3 3 3 1 1 1 5 5 5 5 5 5 5 5 5 5 5 5 5 5 5 5 5 5 1 1 1 1 5 5 5 5 5 5 5 5 5 1 3 3 0
0 0 0 3 3 3 3 3 1 1 5 5 5 5 5 5 5 5 5 5 5 5 1 1 5 5 5 5 1 1 1 1 5 5 5 5 5 5 5 5 5 1 3 3 0
0 0 0 0 0 3 3 3 3 1 1 5 5 5 5 5 5 5 5 5 1 1 1 1 5 5 5 1 1 1 1 1 1 5 5 5 5 5 5 5 5 1 3 3 0
0 0 0 0 0 0 3 3 3 3 1 1 5 5 5 5 5 5 5 5 1 1 1 1 1 5 5 1 1 1 1 1 1 1 1 1 5 5 5 5 5 1 3 3 0
0 0 0 0 0 0 0 3 3 3 3 1 1 1 5 5 5 5 5 5 1 1 1 1 1 1 1 1 1 1 1 1 1 1 1 1 1 5 5 5 1 1 3 3 0
0 0 0 0 0 0 0 0 3 3 3 1 1 1 1 5 5 5 5 1 1 1 1 1 1 1 1 1 1 1 1 1 1 1 1 1 1 5 5 5 1 1 3 3 0
0 0 0 0 0 0 0 0 3 3 1 1 1 1 1 5 5 5 1 1 1 1 1 1 1 1 5 5 1 1 1 1 1 1 1 1 1 5 5 5 1 3 3 3 0
0 0 0 0 0 0 0 0 3 3 1 1 5 5 5 5 5 1 1 1 1 1 1 1 1 1 5 5 5 1 1 1 1 1 1 1 1 1 2 1 1 3 3 3 0
0 0 0 0 0 0 0 0 3 3 1 5 5 5 5 5 5 1 1 1 1 1 1 1 1 1 5 5 5 5 5 5 1 1 1 1 1 1 1 1 1 3 3 3 0
0 0 0 0 0 0 0 0 3 3 1 5 5 5 5 5 5 1 1 1 1 1 1 1 1 5 5 5 5 5 5 5 1 1 1 4 1 1 1 1 1 3 3 0 0
0 0 0 0 0 0 0 0 3 3 1 1 5 5 5 5 5 1 1 1 2 1 1 1 1 5 5 5 5 5 5 5 5 5 5 5 5 5 1 1 3 3 3 0 0
0 0 0 0 0 0 0 0 3 3 3 1 1 5 5 5 5 5 5 5 5 5 1 1 1 5 5 5 5 5 5 5 5 5 5 5 5 5 1 3 3 3 3 0 0
0 0 0 0 0 0 0 0 3 3 3 1 1 5 5 5 5 5 5 5 5 5 1 1 5 5 5 5 5 5 5 5 5 5 5 5 5 5 1 3 3 3 0 0 0
0 0 0 0 0 0 0 0 0 3 3 1 2 5 5 5 5 5 5 5 5 5 1 1 5 5 5 5 5 5 1 1 5 5 5 5 5 1 1 3 3 0 0 0 0
0 0 0 0 0 0 0 0 0 3 3 1 1 5 5 5 5 5 5 5 5 5 5 5 5 5 5 5 5 5 1 1 1 5 5 5 1 1 1 3 3 0 0 0 0
0 0 0 0 0 0 0 0 0 3 3 1 1 5 5 5 5 5 5 5 5 5 5 5 5 5 5 5 1 1 1 1 1 1 1 1 1 1 3 3 3 0 0 0 0
0 0 0 0 0 0 0 0 0 3 3 1 1 5 5 5 5 5 5 5 5 5 5 5 5 5 1 1 1 1 3 3 3 3 3 3 3 3 3 3 3 0 0 0 0
0 0 0 0 0 0 0 0 0 3 3 1 1 1 1 1 5 5 5 5 5 5 5 1 1 1 1 1 3 3 3 3 3 3 3 3 3 3 3 3 0 0 0 0 0
0 0 0 0 0 0 0 0 0 3 3 3 3 3 1 1 1 1 1 1 1 1 1 1 1 3 3 3 3 3 3 3 3 3 3 0 0 0 0 0 0 0 0 0 0
0 0 0 0 0 0 0 0 0 3 3 3 3 3 3 3 3 3 3 3 3 3 3 3 3 3 3 3 3 3 3 3 0 0 0 0 0 0 0 0 0 0 0 0 0
0 0 0 0 0 0 0 0 0 0 0 0 3 3 3 3 3 3 3 3 3 3 3 3 3 3 3 0 0 0 0 0 0 0 0 0 0 0 0 0 0 0 0 0 0
0 0 0 0 0 0 0 0 0 0 0 0 0 0 0 0 0 0 0 0 0 0 0 0 0 0 0 0 0 0 0 0 0 0 0 0 0 0 0 0 0 0 0 0 0
3
3
0 22 30
1 31 15
1 26 33
23
3 15 19
5 12 39
5 6 35
5 7 31
5 24 7
5 39 11
5 39 31
5 38 38
5 27 21
5 3 18
5 11 7
5 14 7
5 13 13
5 11 22
5 9 24
5 31 26
5 31 27
5 32 26
6 27 25
6 14 21
6 12 30
7 6 14
7 32 12
12
3 23 9 18 2
3 25 11 10 2
5 20 36
5 39 24
6 16 30
7 28 28
7 26 35
7 24 35
7 24 33
7 33 39
7 27 12
7 13 19
3
0 7 14
1 38 28
1 25 10
19
3 10 30
5 37 24
5 33 31
5 38 38
5 33 40
5 18 40
5 11 33
5 15 18
5 30 10
5 22 11
5 21 19
5 18 28
5 26 24
5 24 18
5 10 38
5 7 16
6 22 23
6 6 29
7 22 35
12
2 23 15 18 4
4 31 22
4 14 9
5 27 25
5 12 21
5 4 17
5 25 36
5 16 30
6 33 12
7 18 12
7 40 23
7 16 34
3
0 36 11
1 14 21
1 16 24
10
3 16 21
5 33 11
5 41 27
5 19 40
5 9 24
5 7 31
5 13 4
5 41 22
6 23 19
6 21 25
20
0 16 19
0 29 11
1 24 24
2 7 5 10 1
2 4 7 13 1
2 12 12 16 2
3 40 13 12 2
4 18 33
5 13 17
5 35 27
6 16 9
7 36 31
7 31 15
7 24 16
7 36 13
7 31 22
7 31 33
7 24 37
7 12 24
7 4 17