52 55
0 0 0 0 0 0 0 0 0 0 0 0 0 0 0 0 0 0 0 0 0 0 0 0 0 0 0 0 0 0 0 0 0 0 0 0 0 0 0 0 0 0 0 0 0 0 0 0 0 0 0 0 0 0 0
0 0 0 0 3 3 3 3 3 3 3 3 3 3 3 0 0 0 0 0 0 0 0 0 0 0 0 3 3 3 3 3 3 3 3 0 0 0 0 0 0 0 0 0 0 0 0 0 0 0 0 0 0 0 0
0 0 0 3 3 3 3 3 3 3 3 3 3 3 3 3 0 0 0 0 0 3 3 3 3 3 3 3 3 3 3 3 3 3 3 3 3 0 0 0 0 0 0 0 0 0 0 0 0 0 0 0 0 0 0
0 0 3 3 3 3 1 1 1 1 1 1 1 3 3 3 0 0 3 3 3 3 3 3 3 3 3 3 3 1 1 1 1 3 3 3 3 3 3 3 0 0 0 0 0 0 0 0 0 0 0 0 0 0 0
0 0 3 3 3 1 1 5 5 5 5 5 1 1 3 3 3 0 3 3 3 3 3 1 1 1 1 1 1 1 5 5 1 1 1 3 3 3 3 3 3 0 0 0 0 0 0 0 0 0 0 0 0 0 0
0 3 3 3 1 1 5 5 5 5 5 5 5 1 3 3 3 3 3 3 1 1 1 1 5 5 1 1 1 5 5 5 5 5 1 1 1 1 3 3 3 0 0 0 0 0 0 0 0 0 0 0 0 0 0
0 3 3 3 1 5 5 5 5 5 5 5 5 1 1 3 3 3 3 3 1 5 5 5 5 5 5 1 1 5 5 5 5 5 5 5 5 1 1 3 3 3 3 0 0 0 0 0 0 0 0 0 0 0 0
0 3 3 1 1 5 5 5 5 5 5 5 1 1 1 1 1 1 1 1 1 5 5 5 5 5 5 1 1 5 5 5 5 5 5 5 5 5 1 3 3 3 3 0 0 0 0 0 0 0 0 0 0 0 0
0 3 3 1 5 5 5 5 5 5 5 1 1 1 1 1 5 1 1 1 5 5 5 5 5 5 5 5 5 5 5 5 5 5 5 5 5 5 1 1 1 3 3 3 3 3 3 3 3 3 0 0 0 0 0
0 3 3 1 5 5 5 5 5 5 1 1 1 1 5 5 5 1 1 1 5 5 5 1 1 5 5 5 5 5 5 1 1 1 5 5 5 5 5 5 1 3 3 3 3 3 3 3 3 3 0 0 0 0 0
0 3 3 1 5 5 5 5 5 5 1 1 1 5 5 5 5 1 1 1 1 5 5 1 1 5 5 5 5 5 5 1 1 1 1 5 5 5 5 5 1 1 3 3 1 1 1 1 3 3 3 0 0 0 0
0 3 3 1 1 5 5 5 5 5 1 1 5 5 5 5 5 5 1 1 1 5 5 5 5 5 5 5 5 5 5 1 1 1 1 5 5 5 5 5 5 1 1 1 1 5 5 1 1 3 3 3 0 0 0
0 3 3 3 1 1 1 1 1 1 1 1 1 1 5 5 5 5 5 5 5 5 5 5 5 5 5 5 5 5 5 5 1 1 5 5 5 5 5 5 5 1 1 1 5 5 5 5 1 3 3 3 0 0 0
0 3 3 3 1 1 1 1 1 1 1 1 1 1 5 5 5 5 5 5 5 5 5 5 5 5 5 5 5 5 5 5 5 5 5 5 5 5 5 5 5 1 1 5 5 5 5 5 1 1 3 3 3 0 0
0 0 3 3 1 1 5 5 5 5 1 1 1 1 1 5 5 5 5 5 5 5 5 5 5 1 1 1 5 5 5 5 5 5 5 5 5 5 5 5 5 5 5 5 5 5 5 5 5 1 3 3 3 0 0
0 0 3 3 1 5 5 5 5 5 5 1 1 1 1 1 1 1 1 5 5 5 5 5 1 1 1 1 1 5 5 5 5 5 5 5 1 1 5 5 5 5 5 5 5 5 5 5 5 1 1 3 3 0 0
0 0 3 3 1 5 5 5 5 5 5 5 5 1 1 1 1 1 1 1 1 1 1 1 1 1 1 1 1 1 5 5 5 5 5 5 1 1 5 5 5 5 5 5 5 5 5 5 5 5 1 3 3 3 0
0 0 3 3 1 1 5 5 5 5 5 5 5 1 1 1 1 1 1 1 1 1 1 1 1 1 1 1 1 1 1 5 5 5 5 5 1 1 5 5 5 5 5 1 1 1 5 5 5 5 1 3 3 3 0
0 0 3 3 1 1 5 5 5 5 5 5 5 5 1 1 1 5 5 1 1 1 5 5 5 5 1 1 1 1 1 5 5 5 5 5 1 1 5 5 5 1 1 1 1 1 5 5 5 5 1 1 3 3 0
0 3 3 3 1 1 5 5 5 5 5 5 5 5 1 1 1 5 5 1 1 5 5 5 5 5 5 1 1 1 1 1 1 5 5 5 1 1 5 5 5 1 1 1 1 5 5 5 5 5 5 1 3 3 0
0 3 3 3 1 5 5 5 5 5 5 5 5 5 1 1 1 5 5 1 1 5 5 5 5 5 5 5 1 1 1 1 1 5 5 5 5 5 5 5 5 5 1 1 5 5 5 5 5 5 5 1 3 3 0
0 3 3 1 1 5 5 5 1 1 5 5 5 5 5 1 1 1 1 1 1 5 5 5 5 5 5 5 1 1 1 1 5 5 5 5 5 5 5 5 5 5 5 5 5 5 5 5 5 5 5 1 3 3 0
0 3 3 1 5 5 5 5 1 1 1 5 5 5 5 1 1 1 1 1 1 5 5 1 1 5 5 5 1 1 1 1 5 5 5 5 5 5 5 5 5 5 5 5 5 5 5 1 1 5 5 1 3 3 0
0 3 3 1 5 5 5 5 1 1 1 5 5 5 5 5 5 5 5 5 5 5 5 1 1 5 5 5 1 1 1 1 5 5 5 5 5 5 1 1 5 5 5 5 5 5 1 1 1 5 5 1 3 3 0
0 3 3 1 5 5 5 5 1 1 1 5 5 5 5 5 5 5 5 5 5 5 5 1 1 5 5 5 1 1 1 5 5 5 5 5 5 1 1 1 1 1 1 5 5 5 1 1 1 5 5 1 3 3 0
0 3 3 1 5 5 5 5 5 1 1 5 5 5 5 5 5 5 5 5 5 5 5 5 5 5 5 5 5 1 1 5 5 5 5 5 1 1 3 3 3 3 1 1 1 1 1 1 5 5 5 1 3 3 0
0 3 3 1 5 5 5 5 5 1 1 1 5 5 5 5 5 5 1 1 5 5 5 5 5 5 5 5 5 1 1 5 5 5 5 1 1 1 3 3 3 3 1 1 1 1 1 1 1 1 1 1 3 3 0
0 3 3 1 5 5 5 5 1 1 1 1 5 5 5 5 5 1 1 1 5 5 5 5 5 5 5 1 1 1 1 1 5 5 5 1 1 1 1 1 1 1 1 1 1 1 1 3 3 3 3 3 3 3 0
0 3 3 1 5 5 5 5 1 1 1 5 5 5 5 5 5 1 1 1 5 5 5 1 1 1 1 1 1 1 1 1 5 5 5 5 1 1 1 5 5 1 1 1 1 1 1 3 3 3 3 3 3 3 0
0 3 3 1 5 5 5 5 5 5 5 5 5 5 5 5 5 1 1 1 5 5 5 1 1 1 1 1 1 1 1 1 5 5 5 5 1 1 1 5 5 5 5 5 5 5 1 1 1 3 3 3 0 0 0
0 3 3 1 1 5 5 5 5 5 5 5 5 5 5 5 5 1 1 5 5 5 5 5 5 1 1 1 1 1 5 5 5 5 5 5 5 1 1 5 5 5 5 5 5 5 5 5 1 1 3 3 0 0 0
0 3 3 3 1 5 5 5 5 5 5 5 5 5 5 5 1 1 1 5 5 5 5 5 5 5 5 5 5 5 5 5 5 5 5 5 5 5 5 5 5 5 5 5 5 5 5 5 5 1 3 3 0 0 0
0 3 3 3 1 5 5 5 5 5 5 5 5 5 5 1 1 1 1 5 5 5 5 5 5 5 5 5 5 5 5 5 5 5 5 5 5 5 5 5 5 5 5 5 5 5 5 5 5 1 3 3 0 0 0
0 0 3 3 1 1 5 5 5 5 5 5 5 5 1 1 1 1 5 5 5 5 5 5 5 5 5 5 5 5 5 5 5 5 5 5 5 5 5 5 5 5 5 5 5 5 5 5 5 1 3 3 0 0 0
0 0 3 3 3 1 5 5 5 5 5 5 1 1 1 1 1 5 5 5 5 5 5 5 5 5 5 5 5 5 5 5 5 5 5 5 1 1 5 5 5 5 5 5 5 5 5 5 5 1 3 3 0 0 0
0 0 3 3 3 1 1 5 5 5 5 1 1 1 1 1 5 5 5 5 5 5 5 1 1 1 1 1 1 1 1 1 1 5 5 5 1 1 5 5 5 5 5 5 5 5 5 5 1 1 3 3 0 0 0
0 0 0 3 3 3 1 5 5 5 5 1 1 1 1 5 5 5 5 5 1 1 1 1 1 1 1 1 1 1 1 1 1 5 5 5 5 5 5 5 5 1 1 5 5 5 5 5 1 3 3 3 0 0 0
0 0 0 3 3 3 1 5 5 5 5 5 1 1 5 5 5 5 5 1 1 1 1 1 1 5 5 5 5 5 5 1 1 5 5 5 5 5 5 5 1 1 1 1 5 5 5 5 1 3 3 3 0 0 0
0 0 0 0 3 3 1 1 5 5 5 5 5 5 5 5 5 5 1 1 1 1 1 1 1 5 5 5 5 5 5 1 1 1 5 5 5 5 5 5 1 1 1 1 5 5 5 1 1 3 3 0 0 0 0
0 0 0 0 3 3 3 1 5 5 5 5 5 5 5 5 5 5 1 1 1 5 5 1 1 5 5 5 5 5 5 1 1 1 5 5 5 5 5 5 5 1 1 1 1 5 5 1 3 3 3 0 0 0 0
0 0 0 0 3 3 3 1 1 5 5 5 5 5 5 5 5 5 5 5 5 5 5 1 1 1 5 5 5 5 5 5 1 1 5 5 5 5 5 5 5 5 1 1 1 1 1 1 3 3 3 0 0 0 0
0 0 0 0 0 3 3 3 1 1 5 5 5 5 5 5 5 5 5 5 5 5 5 5 5 5 5 5 5 5 5 5 5 5 5 5 5 5 5 5 1 1 1 1 1 1 1 3 3 3 0 0 0 0 0
0 0 0 0 0 3 3 3 3 1 1 5 5 5 5 5 5 5 5 5 5 5 5 5 5 5 5 5 5 5 5 5 5 5 5 5 5 5 5 1 1 3 3 3 3 3 3 3 3 3 0 0 0 0 0
0 0 0 0 0 0 3 3 3 3 1 1 5 5 5 5 5 5 5 5 5 5 5 5 5 5 5 5 5 5 5 5 5 5 5 5 5 5 1 1 3 3 3 3 3 3 3 3 3 0 0 0 0 0 0
0 0 0 0 0 0 0 3 3 3 3 1 1 1 1 1 1 1 1 5 5 5 5 5 5 5 5 5 1 1 1 1 5 5 5 5 5 1 1 3 3 3 3 0 0 0 0 0 0 0 0 0 0 0 0
0 0 0 0 0 0 0 0 3 3 3 3 3 3 3 3 3 3 1 1 1 1 5 5 5 5 1 1 1 1 1 1 5 5 5 5 5 1 3 3 3 3 0 0 0 0 0 0 0 0 0 0 0 0 0
0 0 0 0 0 0 0 0 0 3 3 3 3 3 3 3 3 3 3 3 3 1 1 1 1 1 1 3 3 1 1 5 5 5 5 5 1 1 3 3 3 0 0 0 0 0 0 0 0 0 0 0 0 0 0
0 0 0 0 0 0 0 0 0 0 0 0 0 0 0 0 3 3 3 3 3 3 3 3 3 3 3 3 3 1 5 5 5 5 1 1 1 3 3 3 0 0 0 0 0 0 0 0 0 0 0 0 0 0 0
0 0 0 0 0 0 0 0 0 0 0 0 0 0 0 0 0 0 0 3 3 3 3 3 3 3 3 3 3 1 1 1 1 1 1 3 3 3 3 3 0 0 0 0 0 0 0 0 0 0 0 0 0 0 0
0 0 0 0 0 0 0 0 0 0 0 0 0 0 0 0 0 0 0 0 0 0 0 0 0 0 0 3 3 3 3 3 3 3 3 3 3 3 3 0 0 0 0 0 0 0 0 0 0 0 0 0 0 0 0
0 0 0 0 0 0 0 0 0 0 0 0 0 0 0 0 0 0 0 0 0 0 0 0 0 0 0 3 3 3 3 3 3 3 3 3 3 0 0 0 0 0 0 0 0 0 0 0 0 0 0 0 0 0 0
0 0 0 0 0 0 0 0 0 0 0 0 0 0 0 0 0 0 0 0 0 0 0 0 0 0 0 0 0 0 0 0 0 0 0 0 0 0 0 0 0 0 0 0 0 0 0 0 0 0 0 0 0 0 0
1
4
0 23 15
0 12 34
1 12 14
1 45 32
31
3 30 46
5 5 33
5 6 21
5 11 46
5 14 9
5 18 22
5 24 31
5 25 28
5 28 11
5 28 39
5 33 18
5 38 8
5 39 40
5 25 8
5 22 4
5 10 9
5 9 4
5 16 42
5 38 45
5 21 14
5 36 33
5 30 24
5 17 31
5 14 23
5 11 40
5 40 15
5 37 29
5 38 30
5 37 25
6 24 49
6 40 21