51 50
0 0 0 0 0 0 0 0 0 0 0 0 0 0 0 0 0 0 0 0 0 0 0 0 0 0 0 0 0 0 0 0 0 0 0 0 0 0 0 0 0 0 0 0 0 0 0 0 0 0
0 0 0 0 0 0 0 0 0 0 0 3 3 3 3 3 3 3 3 3 3 0 0 0 0 0 0 0 0 0 0 0 0 0 0 0 0 0 0 0 0 0 0 0 0 0 0 0 0 0
0 0 0 0 0 0 0 0 0 0 3 3 3 3 3 3 3 3 3 3 3 3 0 0 0 0 0 0 0 0 0 0 0 0 0 0 0 0 0 0 0 0 0 0 0 0 0 0 0 0
0 0 0 0 0 0 0 0 0 0 3 3 3 1 1 1 1 1 1 3 3 3 0 0 0 0 0 0 0 0 0 0 0 0 0 0 0 0 0 0 0 0 0 0 0 0 0 0 0 0
0 0 0 0 0 0 0 0 0 3 3 3 1 1 5 5 5 5 1 1 3 3 3 0 0 0 0 0 0 0 0 0 0 0 0 0 0 0 0 0 0 0 0 0 0 0 0 0 0 0
0 0 0 3 3 3 3 3 3 3 3 3 1 5 5 5 5 5 5 1 3 3 3 3 0 0 0 0 0 0 0 0 0 0 0 0 0 0 0 0 0 0 0 0 0 0 0 0 0 0
0 0 3 3 3 3 3 3 3 3 3 1 1 5 5 5 5 5 5 1 1 3 3 3 3 0 0 0 0 0 0 0 0 0 0 0 0 0 0 0 0 0 0 0 0 0 0 0 0 0
0 0 3 3 3 6 6 6 6 6 1 1 1 5 5 5 5 5 5 5 1 1 3 3 3 3 0 0 0 0 0 0 0 0 0 0 0 0 0 0 0 0 0 0 0 0 0 0 0 0
0 3 3 3 6 6 6 6 6 6 6 1 5 5 5 5 5 5 5 5 1 1 1 3 3 3 3 0 0 0 0 0 0 0 3 3 3 3 3 0 0 0 0 0 0 0 0 0 0 0
0 3 3 3 6 6 6 6 6 6 6 1 5 5 5 5 5 5 5 5 1 1 1 1 3 3 3 3 3 0 0 0 3 3 3 3 3 3 3 0 0 0 0 0 0 0 0 0 0 0
0 3 3 6 6 6 6 6 6 6 1 1 5 5 5 5 5 5 5 5 5 1 1 1 1 3 3 3 3 3 3 3 3 3 3 3 1 3 3 0 0 0 0 0 0 0 0 0 0 0
0 3 3 6 6 6 6 6 6 1 1 5 5 5 5 5 5 5 5 5 5 5 5 1 1 1 1 3 3 3 3 3 3 3 1 1 1 3 3 0 0 0 0 0 0 0 0 0 0 0
0 3 3 6 6 6 6 6 6 1 5 5 5 5 5 5 5 5 5 5 5 5 5 1 1 1 1 1 6 6 6 6 1 1 1 1 1 3 3 0 0 0 0 0 0 0 0 0 0 0
0 3 3 6 6 6 6 6 6 1 5 5 5 5 5 5 5 5 5 5 5 5 5 1 1 1 6 6 6 6 6 6 6 1 1 1 3 3 3 0 0 0 0 0 0 0 0 0 0 0
0 3 3 6 6 6 6 6 6 1 1 1 2 1 1 5 5 5 5 5 5 5 5 1 1 6 6 6 6 6 6 6 6 6 3 3 3 3 3 0 0 0 0 0 0 0 0 0 0 0
0 3 3 3 6 6 6 6 6 6 6 6 6 1 1 5 5 5 5 5 5 5 5 5 1 6 6 6 6 6 6 6 6 6 3 3 3 3 0 0 0 0 0 0 0 0 0 0 0 0
0 3 3 3 3 6 6 6 6 6 6 6 6 6 1 5 5 5 5 5 5 5 5 5 1 1 6 6 6 6 6 6 6 6 3 3 3 0 0 0 0 0 0 3 3 3 3 3 0 0
0 0 3 3 3 3 3 6 6 6 6 6 6 6 1 1 5 5 5 5 5 5 5 5 5 1 6 6 6 6 6 6 6 6 1 3 3 0 0 0 0 3 3 3 3 3 3 3 0 0
0 0 0 3 3 3 3 1 6 6 6 6 6 6 6 1 1 5 5 5 5 5 5 5 5 1 1 6 6 6 6 6 6 3 3 3 3 3 3 3 3 3 3 3 3 1 3 3 0 0
0 0 0 0 3 3 3 1 6 6 6 6 6 6 6 6 1 5 5 5 5 5 5 5 5 5 1 6 6 6 6 6 3 3 3 3 3 3 3 3 3 3 3 1 1 1 3 3 0 0
0 0 0 3 3 3 3 6 6 6 6 6 6 6 6 6 1 1 5 5 5 5 5 5 5 5 1 6 6 6 6 6 3 3 3 3 3 3 3 1 3 3 1 1 1 1 3 3 3 0
0 0 0 3 3 3 6 6 6 6 6 6 6 6 6 6 6 1 1 5 5 5 5 5 5 5 1 6 6 6 6 6 3 3 3 3 3 3 3 1 1 1 1 1 1 1 3 3 3 0
0 0 3 3 3 6 6 6 6 6 6 6 6 6 6 6 6 6 1 1 5 5 5 5 5 5 1 1 6 6 6 6 6 3 3 3 3 3 1 1 1 1 1 1 1 1 1 3 3 0
0 0 3 3 3 6 6 6 6 6 6 6 6 6 6 6 6 6 1 1 5 5 5 5 5 5 5 1 6 6 6 6 6 3 3 3 3 3 1 1 1 1 1 1 1 1 1 3 3 0
0 3 3 3 6 6 6 6 6 6 6 3 3 3 6 6 6 6 1 1 5 5 5 5 5 5 5 1 6 6 6 6 6 6 3 3 3 1 1 1 1 1 3 3 1 1 1 3 3 0
0 3 3 3 6 6 6 6 6 6 6 3 3 3 6 6 6 6 6 1 5 5 5 5 5 5 1 1 6 6 6 6 6 6 6 6 6 6 1 1 1 1 3 3 1 1 1 3 3 0
0 3 3 6 6 6 6 6 6 6 6 6 6 6 6 6 6 6 6 1 1 5 5 5 5 5 1 1 6 6 6 6 6 6 6 6 6 6 6 1 1 1 1 1 1 1 1 3 3 0
0 3 3 6 6 6 6 6 6 6 6 6 6 6 6 6 6 6 6 1 1 1 5 5 5 5 1 1 6 6 6 6 6 6 6 6 6 6 6 6 1 1 1 1 1 1 3 3 3 0
0 3 3 6 6 6 6 6 6 6 6 6 6 6 6 6 6 6 6 1 1 1 5 5 5 5 5 1 1 6 6 6 6 6 6 6 6 6 6 6 6 1 1 1 1 1 3 3 3 0
0 3 3 6 6 6 6 6 6 6 6 6 6 6 6 6 6 6 6 1 1 1 5 5 5 5 5 5 1 6 6 6 6 6 6 6 6 6 6 6 6 1 1 1 3 3 3 3 0 0
0 3 3 6 6 6 6 6 6 6 6 6 6 6 6 6 6 6 6 1 1 1 5 5 5 5 5 5 1 1 6 6 6 6 6 3 3 6 6 6 6 1 3 3 3 3 3 3 0 0
0 3 3 3 6 6 6 6 3 3 6 6 6 6 6 6 6 6 1 1 5 5 5 5 5 5 5 5 5 1 6 6 6 6 6 3 3 6 6 6 6 3 3 3 3 3 0 0 0 0
0 3 3 3 6 6 6 6 3 3 3 6 6 6 6 6 6 6 1 5 5 5 5 5 5 5 5 5 5 1 1 6 6 6 6 6 6 6 6 6 3 3 3 3 0 0 0 0 0 0
0 0 3 3 3 6 6 6 3 3 3 6 6 6 6 6 6 6 1 5 5 5 5 5 5 5 5 5 1 1 1 6 6 6 6 6 6 6 6 6 3 3 3 3 0 0 0 0 0 0
0 0 3 3 3 6 6 6 6 6 6 6 6 6 6 6 6 6 2 5 5 5 5 5 5 5 5 5 1 1 6 6 6 6 6 6 6 6 6 6 6 3 3 3 3 0 0 0 0 0
0 0 0 3 3 3 6 6 6 6 6 6 6 6 6 6 6 6 1 5 5 5 5 5 5 5 5 5 1 6 6 6 6 6 6 6 6 6 6 6 6 6 3 3 3 0 0 0 0 0
0 0 0 3 3 3 3 6 6 6 6 6 6 6 6 6 6 1 1 5 5 5 5 5 5 5 5 5 2 6 6 6 6 6 6 6 6 6 6 6 6 6 6 3 3 3 0 0 0 0
0 0 0 0 3 3 3 3 6 6 6 6 6 6 6 6 1 1 1 5 5 5 5 5 5 5 5 5 1 6 6 6 6 6 6 6 6 3 3 6 6 6 6 3 3 3 0 0 0 0
0 0 0 0 0 3 3 3 3 3 6 6 6 6 6 1 3 3 1 1 5 5 5 5 5 5 5 5 1 1 6 6 6 6 6 6 6 3 3 6 6 6 6 6 3 3 3 0 0 0
0 0 0 0 0 0 3 3 3 3 3 3 3 1 1 1 3 3 3 1 5 5 5 5 5 5 5 5 5 1 1 6 6 6 6 6 6 6 6 6 6 6 6 6 3 3 3 0 0 0
0 0 0 0 0 0 0 0 3 3 3 3 3 3 3 3 3 3 3 1 1 5 2 1 1 1 1 1 1 1 1 1 6 6 6 6 6 6 6 6 6 6 6 6 1 3 3 0 0 0
0 0 0 0 0 0 0 0 0 0 0 3 3 3 3 3 3 3 3 1 6 6 6 6 6 3 3 3 3 3 3 3 3 3 3 6 6 6 6 6 6 6 6 1 1 3 3 0 0 0
0 0 0 0 0 0 0 0 0 0 0 0 0 0 3 3 3 3 3 6 6 6 6 6 6 3 3 3 3 3 3 3 3 3 3 3 3 3 6 6 6 6 1 1 3 3 3 0 0 0
0 0 0 0 0 0 0 0 0 0 0 0 0 0 0 3 3 3 6 6 6 6 6 6 6 6 3 3 3 0 0 0 0 3 3 3 3 3 3 1 1 1 1 1 3 3 3 0 0 0
0 0 0 0 0 0 0 0 0 0 0 0 0 0 0 3 3 6 6 6 6 6 6 6 6 6 3 3 0 0 0 0 0 0 0 0 3 3 3 3 3 1 1 3 3 3 0 0 0 0
0 0 0 0 0 0 0 0 0 0 0 0 0 0 0 3 3 6 6 6 6 6 6 6 6 6 3 3 0 0 0 0 0 0 0 0 0 3 3 3 3 3 3 3 3 3 0 0 0 0
0 0 0 0 0 0 0 0 0 0 0 0 0 0 0 3 3 3 6 6 6 6 6 6 6 3 3 3 0 0 0 0 0 0 0 0 0 0 0 3 3 3 3 3 3 0 0 0 0 0
0 0 0 0 0 0 0 0 0 0 0 0 0 0 0 3 3 3 3 6 6 6 6 6 3 3 3 3 0 0 0 0 0 0 0 0 0 0 0 0 0 0 0 0 0 0 0 0 0 0
0 0 0 0 0 0 0 0 0 0 0 0 0 0 0 0 3 3 3 3 3 3 3 3 3 3 3 0 0 0 0 0 0 0 0 0 0 0 0 0 0 0 0 0 0 0 0 0 0 0
0 0 0 0 0 0 0 0 0 0 0 0 0 0 0 0 0 3 3 3 3 3 3 3 3 3 0 0 0 0 0 0 0 0 0 0 0 0 0 0 0 0 0 0 0 0 0 0 0 0
0 0 0 0 0 0 0 0 0 0 0 0 0 0 0 0 0 0 0 0 0 0 0 0 0 0 0 0 0 0 0 0 0 0 0 0 0 0 0 0 0 0 0 0 0 0 0 0 0 0
3
0 22 22 1 21 44 1 31 5
0