55 48
0 0 0 0 0 0 0 0 0 0 0 0 0 0 0 0 0 0 0 0 0 0 0 0 0 0 0 0 0 0 0 0 0 0 0 0 0 0 0 0 0 0 0 0 0 0 0 0
0 0 0 0 0 0 0 0 0 0 0 0 0 0 0 0 0 0 0 0 0 0 0 0 0 3 3 3 3 3 3 3 3 3 3 3 3 3 0 0 0 0 0 0 0 0 0 0
0 0 0 0 0 0 0 0 0 0 0 0 0 0 0 0 0 0 0 0 0 0 3 3 3 3 3 3 3 3 3 3 3 3 3 3 3 3 3 3 0 0 0 0 0 0 0 0
0 0 0 0 0 0 0 0 0 0 0 0 0 0 0 0 0 0 0 0 3 3 3 3 3 3 3 1 1 1 1 1 1 1 1 1 3 3 3 3 3 0 0 0 0 0 0 0
0 0 0 0 0 0 0 0 0 0 0 0 0 0 0 0 0 0 3 3 3 3 3 3 1 1 1 1 5 5 5 5 5 5 5 1 1 1 3 3 3 3 3 0 0 0 0 0
0 0 0 0 0 0 0 0 0 0 0 0 0 0 0 0 0 3 3 3 3 3 1 1 1 5 5 5 5 5 5 5 5 5 5 5 5 1 1 3 3 3 3 3 3 0 0 0
0 0 0 0 0 0 0 0 0 0 0 0 0 0 0 0 0 3 3 3 1 1 1 5 5 5 5 5 5 5 5 5 5 5 5 5 5 5 1 1 1 3 3 3 3 3 0 0
0 0 0 0 0 0 0 0 0 0 0 0 0 0 0 0 0 3 3 1 1 5 5 5 5 5 5 5 5 5 5 5 5 5 5 5 5 5 5 1 1 1 1 3 3 3 0 0
0 0 0 0 0 0 0 0 0 0 0 0 0 0 0 0 0 3 3 1 5 5 5 5 5 5 5 5 5 5 5 5 5 5 5 5 5 5 5 1 1 1 1 1 3 3 3 0
0 0 0 0 0 0 0 0 0 0 0 0 0 0 0 0 3 3 3 1 5 5 5 5 5 5 5 5 5 5 5 1 1 1 5 5 5 5 5 1 1 1 1 1 3 3 3 0
0 0 0 0 0 0 0 0 0 3 3 3 3 3 3 3 3 3 3 1 5 5 5 5 5 5 5 5 5 5 1 1 1 1 1 1 2 1 1 1 1 1 1 1 1 3 3 0
0 0 0 0 0 0 0 0 3 3 3 3 3 3 3 3 3 3 1 1 5 5 5 5 5 5 5 5 5 1 1 1 1 1 6 6 6 6 6 1 1 1 1 1 1 3 3 0
0 0 0 0 0 0 0 3 3 3 3 1 1 1 1 1 1 1 1 1 1 5 5 5 5 5 5 5 5 1 1 1 1 6 6 6 6 6 6 6 6 6 1 1 1 3 3 0
0 0 0 0 0 0 3 3 3 3 1 1 5 5 5 5 5 1 1 1 1 5 5 5 5 5 5 5 5 1 1 1 6 6 6 6 6 6 6 6 6 6 6 1 1 3 3 0
0 0 0 0 0 3 3 3 3 1 1 5 5 5 5 5 5 5 1 1 1 1 1 5 5 5 5 5 5 1 1 6 6 6 6 6 6 6 6 6 6 6 6 6 1 3 3 0
0 0 0 0 0 3 3 3 1 1 5 5 5 5 5 5 5 5 5 1 1 1 1 1 5 5 5 5 1 1 1 6 6 6 6 6 6 6 6 6 6 6 6 6 6 3 3 0
0 0 0 0 3 3 3 1 1 5 5 5 5 5 5 5 5 5 5 1 1 1 1 1 5 5 5 5 1 1 1 6 6 6 6 6 6 6 6 6 6 6 6 6 6 3 3 0
0 0 0 0 3 3 3 1 5 5 5 5 5 5 5 5 5 5 5 1 1 1 1 1 5 5 5 5 2 1 6 6 6 6 6 6 6 6 6 6 6 6 6 6 6 3 3 0
0 0 0 0 3 3 1 1 5 5 5 5 5 5 5 5 5 5 5 1 1 1 1 1 5 5 5 5 1 1 6 6 6 6 6 6 6 6 6 6 6 6 6 6 6 3 3 0
0 0 0 0 3 3 1 5 5 5 5 5 5 5 5 5 5 5 1 1 1 1 1 1 5 5 5 5 1 1 6 6 6 6 6 6 6 6 6 6 6 6 6 6 6 3 3 0
0 0 0 3 3 3 1 5 5 5 5 5 5 5 5 5 5 5 1 1 1 1 1 1 5 5 5 5 1 1 1 6 6 6 6 6 6 6 6 6 6 6 6 6 1 3 3 0
0 0 0 3 3 3 1 5 5 5 5 5 5 5 5 5 5 5 5 1 1 1 1 1 5 5 5 5 5 1 1 1 6 6 6 6 6 6 6 6 6 6 1 1 1 3 3 0
0 0 0 3 3 1 1 5 5 5 5 5 5 5 5 5 5 5 5 5 1 1 5 5 5 5 5 5 5 1 1 1 1 6 6 6 6 1 1 1 1 2 1 1 1 3 3 0
0 0 3 3 3 1 5 5 5 5 5 5 5 5 1 1 5 5 5 5 5 5 5 5 5 5 5 5 5 1 1 1 1 1 1 1 1 1 1 5 5 5 5 5 1 3 3 0
0 0 3 3 3 1 5 5 5 5 5 5 5 1 1 1 1 5 5 5 5 5 5 5 5 5 5 5 5 1 1 1 1 1 1 1 1 1 1 5 5 5 5 5 1 3 3 0
0 0 3 3 1 1 5 5 5 5 5 5 1 1 1 1 1 1 5 5 5 5 5 5 5 5 5 5 5 1 1 1 1 1 1 1 1 1 5 5 5 5 5 5 1 3 3 0
0 3 3 3 1 5 5 5 5 5 5 1 1 1 1 1 1 1 1 5 5 5 5 5 5 5 5 5 5 5 1 1 1 1 1 1 1 1 5 5 5 5 5 5 1 3 3 0
0 3 3 3 1 5 5 5 5 5 1 1 1 1 1 1 1 1 1 1 1 5 5 5 5 5 5 5 5 5 5 5 1 1 1 1 1 1 5 5 5 5 5 1 1 3 3 0
0 3 3 1 1 5 5 5 5 5 1 1 1 1 1 1 1 1 1 1 1 1 5 5 5 5 5 5 5 5 5 5 5 5 1 1 1 5 5 5 5 5 5 1 3 3 3 0
0 3 3 1 5 5 5 5 5 1 1 1 1 1 1 1 1 1 1 1 1 1 5 5 5 5 5 5 5 5 5 5 5 5 5 5 5 5 5 5 5 5 5 1 3 3 3 0
0 3 3 1 5 5 5 5 5 1 1 1 1 1 1 1 1 1 1 1 1 1 5 5 5 5 5 1 1 1 5 5 5 5 5 5 5 5 5 5 5 5 1 1 3 3 0 0
0 3 3 1 5 5 5 5 5 5 1 1 1 1 1 1 1 1 1 1 1 1 1 5 5 5 1 1 1 1 1 5 5 5 5 5 5 5 5 5 5 5 1 3 3 3 0 0
0 3 3 1 5 5 5 5 5 5 5 1 1 1 1 1 1 1 1 1 1 1 1 1 1 1 1 1 1 1 1 1 5 5 5 5 5 5 5 5 5 1 1 3 3 3 0 0
0 3 3 1 5 5 5 5 5 5 5 5 1 1 1 1 1 1 1 1 1 1 1 1 1 1 1 1 1 1 1 1 5 5 5 5 5 5 5 5 5 1 3 3 3 0 0 0
0 3 3 1 1 5 5 5 5 5 5 5 5 1 1 1 1 1 1 1 1 1 1 1 1 1 1 1 1 1 1 5 5 5 5 5 5 5 5 5 1 1 3 3 3 0 0 0
0 3 3 3 1 1 5 5 5 5 5 5 5 5 1 1 1 1 1 1 1 2 1 1 1 1 1 1 1 1 1 5 5 5 5 5 5 5 5 5 1 3 3 3 0 0 0 0
0 3 3 3 3 1 1 5 5 5 5 5 5 5 1 1 1 1 1 1 5 5 5 1 1 1 1 1 1 1 1 5 5 5 5 5 5 5 5 1 1 3 3 3 0 0 0 0
0 0 3 3 3 1 1 5 5 5 5 5 5 5 5 1 1 1 1 5 5 5 5 5 1 1 1 1 1 1 5 5 5 5 5 5 5 5 5 1 3 3 3 0 0 0 0 0
0 3 3 3 3 1 1 5 5 5 5 5 5 5 5 5 5 5 5 5 5 5 5 5 1 1 1 1 1 1 5 5 5 5 5 5 1 1 1 1 3 3 3 0 0 0 0 0
0 3 3 3 1 1 5 5 5 5 5 5 5 5 5 5 5 5 5 5 5 5 5 5 5 1 1 1 1 1 5 5 5 5 5 1 1 3 3 3 3 3 0 0 0 0 0 0
0 3 3 1 1 5 5 5 5 5 5 5 5 5 5 5 5 5 5 5 5 5 5 5 5 1 1 1 1 1 5 5 5 5 1 1 3 3 3 3 3 3 0 0 0 0 0 0
0 3 3 1 5 5 5 5 5 5 5 5 1 1 1 1 5 5 5 5 5 5 5 5 5 1 1 1 1 1 5 5 5 5 1 1 3 3 3 0 0 0 0 0 0 0 0 0
0 3 3 1 5 5 5 5 5 5 1 1 1 3 3 1 1 5 5 5 5 5 5 5 5 5 1 1 1 1 5 5 5 5 5 1 3 3 0 0 0 0 0 0 0 0 0 0
0 3 3 1 1 5 5 5 5 1 1 3 3 3 3 3 1 1 5 5 5 5 5 5 5 5 5 1 1 5 5 5 5 5 5 1 3 3 0 0 0 0 0 0 0 0 0 0
0 3 3 3 1 1 5 5 1 1 3 3 3 3 3 3 3 1 5 5 5 5 5 5 5 5 5 5 5 5 5 5 5 5 5 1 3 3 0 0 0 0 0 0 0 0 0 0
0 3 3 3 3 1 1 1 1 3 3 3 3 0 3 3 3 1 5 5 5 5 5 5 5 5 5 5 5 5 5 5 5 5 5 1 3 3 0 0 0 0 0 0 0 0 0 0
0 0 3 3 3 3 3 3 3 3 3 3 0 0 0 3 3 1 5 5 5 5 5 5 5 5 5 5 5 5 5 5 5 1 1 1 3 3 0 0 0 0 0 0 0 0 0 0
0 0 0 3 3 3 3 3 3 3 3 0 0 0 0 3 3 1 1 5 5 5 5 5 5 5 5 5 5 1 1 1 1 1 3 3 3 3 0 0 0 0 0 0 0 0 0 0
0 0 0 0 0 0 0 0 0 0 0 0 0 0 0 3 3 3 1 1 5 5 5 5 5 5 5 1 1 1 3 3 3 3 3 3 3 3 0 0 0 0 0 0 0 0 0 0
0 0 0 0 0 0 0 0 0 0 0 0 0 0 0 3 3 3 3 1 1 5 5 5 1 1 1 1 3 3 3 3 3 3 3 3 0 0 0 0 0 0 0 0 0 0 0 0
0 0 0 0 0 0 0 0 0 0 0 0 0 0 0 0 3 3 3 3 1 1 2 1 1 3 3 3 3 3 3 3 0 0 0 0 0 0 0 0 0 0 0 0 0 0 0 0
0 0 0 0 0 0 0 0 0 0 0 0 0 0 0 0 0 3 3 3 1 1 1 1 1 3 3 3 3 3 0 0 0 0 0 0 0 0 0 0 0 0 0 0 0 0 0 0
0 0 0 0 0 0 0 0 0 0 0 0 0 0 0 0 0 0 3 3 3 3 3 3 3 3 3 0 0 0 0 0 0 0 0 0 0 0 0 0 0 0 0 0 0 0 0 0
0 0 0 0 0 0 0 0 0 0 0 0 0 0 0 0 0 0 3 3 3 3 3 3 3 3 3 0 0 0 0 0 0 0 0 0 0 0 0 0 0 0 0 0 0 0 0 0
0 0 0 0 0 0 0 0 0 0 0 0 0 0 0 0 0 0 0 0 0 0 0 0 0 0 0 0 0 0 0 0 0 0 0 0 0 0 0 0 0 0 0 0 0 0 0 0
3
0 8 41 0 27 14 1 43 6
0