38 58
0 0 0 0 0 0 0 0 0 0 0 0 0 0 0 0 0 0 0 0 0 0 0 0 0 0 0 0 0 0 0 0 0 0 0 0 0 0 0 0 0 0 0 0 0 0 0 0 0 0 0 0 0 0 0 0 0 0 
0 0 0 3 3 3 3 3 3 3 3 3 3 0 0 0 0 0 0 3 3 3 3 3 0 0 0 0 0 0 0 0 0 0 0 0 0 0 0 0 0 0 0 3 3 3 3 3 3 3 3 3 3 3 3 3 0 0
0 3 3 3 3 3 3 3 3 3 3 3 3 3 3 3 3 3 3 3 3 3 3 3 3 0 0 0 0 0 3 3 3 0 0 0 0 0 0 0 0 3 3 3 3 3 3 3 3 3 3 3 3 3 3 3 3 0 
0 3 3 3 3 1 1 1 1 1 1 3 3 3 3 3 3 3 3 3 3 1 1 3 3 3 0 0 0 3 3 3 3 3 0 0 0 0 0 0 3 3 3 3 3 1 1 1 1 1 1 1 1 3 3 3 3 0 
0 3 3 1 1 1 5 5 1 1 1 1 1 1 1 1 1 3 3 3 1 1 1 3 3 3 3 0 0 3 3 3 3 3 3 0 0 0 0 3 3 3 3 3 1 1 6 6 6 6 6 6 1 1 3 3 3 0 
0 3 3 1 1 5 5 5 1 1 1 1 1 1 1 1 1 1 3 3 1 1 1 1 3 3 3 3 3 3 3 3 3 3 3 3 0 0 3 3 3 3 3 1 1 6 6 6 6 6 6 6 6 1 1 3 3 0 
0 3 3 1 5 5 5 5 1 1 3 3 3 3 3 1 1 1 1 1 1 1 1 1 3 3 3 3 3 3 3 1 1 1 3 3 3 3 3 3 3 1 1 1 6 6 6 6 6 6 6 6 6 1 3 3 3 0 
0 3 3 1 5 5 5 5 1 1 3 3 3 3 3 3 1 1 1 1 1 5 1 1 1 1 3 3 3 3 1 1 1 1 3 3 3 3 3 3 3 1 1 6 6 6 6 6 6 1 1 1 1 1 3 3 3 0 
0 3 3 1 5 5 5 1 1 1 3 3 3 3 3 3 3 3 1 1 5 5 1 1 1 1 1 1 1 1 1 1 1 1 1 1 3 3 3 3 3 1 6 6 6 6 6 6 1 1 1 1 1 3 3 3 0 0 
0 3 3 1 5 5 5 1 1 1 1 3 3 3 3 3 3 3 1 1 5 5 5 5 5 5 1 1 4 1 1 1 1 1 1 1 1 1 3 3 1 1 6 6 6 6 6 6 6 1 1 1 1 3 3 3 0 0 
0 3 3 1 5 5 5 5 5 5 1 3 3 3 3 3 3 1 1 1 5 5 5 5 5 5 5 5 5 5 5 5 5 5 1 1 1 1 1 1 1 1 6 6 6 6 6 6 6 6 6 6 1 1 3 3 0 0 
0 3 3 1 5 5 5 5 5 5 1 1 3 3 3 3 1 1 5 5 5 5 5 5 5 5 5 5 5 5 5 5 5 5 5 1 1 1 1 1 1 1 1 6 6 6 6 6 6 6 6 6 6 1 3 3 3 0 
0 3 3 1 1 5 5 5 5 5 5 1 1 3 3 1 1 5 5 5 5 5 5 5 5 5 5 5 5 5 5 5 5 5 5 1 1 3 3 3 3 1 1 1 6 6 6 6 6 6 6 6 6 1 3 3 3 0 
0 3 3 3 1 5 5 5 5 5 5 1 1 1 1 1 5 5 5 5 5 5 5 5 5 1 1 1 1 5 5 5 5 5 5 5 1 3 3 3 3 3 3 1 1 1 1 1 1 1 6 6 6 1 1 3 3 0 
0 3 3 3 1 1 1 5 5 5 1 1 1 1 1 5 5 5 5 5 5 5 5 5 1 1 3 3 1 1 1 5 5 5 5 5 1 1 3 3 3 3 3 3 3 1 6 6 1 1 6 6 1 1 1 3 3 0 
0 0 3 3 3 1 1 5 5 5 1 1 1 5 5 5 5 5 5 5 5 5 5 1 1 1 3 3 3 3 1 1 5 5 5 5 5 1 1 3 3 3 3 3 3 1 6 6 1 1 6 6 1 3 1 3 3 0 
0 0 3 3 3 1 1 5 5 5 5 1 1 5 5 5 5 5 5 5 5 5 5 1 1 1 3 3 3 3 3 1 5 5 5 5 5 5 1 1 1 1 1 1 1 1 1 1 1 1 1 1 1 1 1 3 3 0 
0 3 3 3 1 1 1 5 5 5 5 5 5 5 5 5 5 5 5 5 5 5 5 5 1 1 3 3 3 3 3 1 5 5 5 5 5 5 5 5 5 5 1 1 1 1 1 6 6 1 1 1 1 1 3 3 3 0 
0 3 3 3 1 1 5 5 5 5 5 5 5 5 5 5 1 1 1 1 5 5 5 5 1 1 1 3 3 3 3 1 5 5 5 5 5 5 5 5 5 5 5 5 5 1 1 6 6 6 1 1 1 3 3 3 3 0 
0 3 3 1 1 5 5 5 5 5 5 5 5 5 5 1 1 3 3 1 5 5 5 5 5 1 1 1 3 3 3 1 5 5 5 5 5 5 5 5 5 5 5 5 5 5 1 6 6 6 1 1 3 3 3 3 0 0 
0 3 3 1 5 5 5 5 5 5 5 5 5 5 5 1 1 3 3 1 5 5 5 5 5 5 5 1 1 3 3 1 1 5 5 5 5 5 5 5 5 5 5 5 5 5 1 6 6 6 3 3 3 3 3 0 0 0 
0 3 3 1 5 5 5 5 5 5 5 5 5 5 1 1 1 3 3 1 1 5 5 5 5 5 5 1 1 3 3 3 1 5 5 5 5 5 5 5 5 5 5 5 5 5 2 6 6 6 3 3 3 3 3 3 3 0 
0 3 3 1 5 5 5 5 5 5 5 5 5 5 1 1 1 3 3 1 1 1 1 5 5 5 5 5 1 3 3 3 1 1 5 5 5 5 5 5 5 5 5 5 5 5 1 6 6 6 6 6 6 3 3 3 3 0 
0 3 3 1 5 5 5 5 5 5 5 5 5 5 5 1 1 3 3 3 1 1 1 5 5 5 5 5 1 1 3 3 3 1 1 1 1 5 5 5 5 5 5 5 5 5 1 6 6 6 6 6 6 6 6 3 3 0 
0 3 3 1 5 5 5 5 5 5 5 5 5 5 5 1 1 3 3 3 3 1 1 5 5 5 5 5 5 1 3 3 3 3 3 1 1 1 1 5 5 5 5 5 5 5 1 6 6 3 3 6 6 6 6 3 3 0 
0 3 3 1 5 5 5 5 5 5 5 5 5 5 1 1 1 3 3 3 3 1 1 5 5 5 5 5 5 1 1 3 3 3 3 1 1 1 1 5 5 5 5 5 5 1 1 6 6 3 3 3 6 6 6 3 3 0 
0 3 3 1 1 1 5 5 5 5 5 5 1 1 1 1 1 3 3 3 1 1 1 5 5 5 5 5 5 5 1 1 1 3 3 1 1 5 5 5 5 5 5 5 1 1 1 6 6 3 3 3 6 6 6 3 3 0 
0 3 3 3 3 1 5 5 5 5 1 1 1 3 3 3 1 1 1 1 1 1 5 5 5 5 5 5 5 5 5 1 1 1 1 1 1 5 5 5 5 5 5 5 1 6 6 6 6 6 6 6 6 6 3 3 3 0 
0 3 3 3 3 1 5 5 5 1 1 3 3 3 3 3 3 3 3 1 1 1 5 5 5 5 5 5 5 5 5 5 1 1 1 1 1 5 5 5 5 5 5 5 1 6 6 6 6 6 6 6 6 6 3 3 3 0 
0 0 3 3 3 1 1 1 1 1 1 3 3 3 3 3 3 3 3 1 1 1 5 5 5 5 5 5 5 5 5 5 5 1 1 1 1 5 5 5 5 5 5 5 1 6 6 6 6 6 6 6 6 3 3 3 3 0 
0 0 0 3 3 3 1 1 3 3 3 3 3 3 0 3 3 3 1 1 1 5 5 5 5 5 5 5 5 5 5 5 1 1 1 1 1 1 1 5 5 5 5 5 1 6 6 6 6 6 6 6 6 3 3 3 3 0 
0 0 0 3 3 3 3 3 3 3 3 3 3 0 3 3 3 3 1 1 5 5 5 5 5 5 5 5 5 5 5 1 1 3 3 3 3 3 1 5 5 5 1 1 1 6 6 6 6 6 6 3 3 3 3 3 0 0 
0 0 0 0 3 3 3 3 3 3 0 0 0 0 3 3 3 3 1 1 5 5 5 5 5 5 5 5 5 1 1 1 3 3 3 3 3 3 1 1 1 1 1 1 1 1 1 1 3 3 3 3 3 3 3 3 0 0 
0 0 0 0 0 0 0 0 0 0 0 0 0 0 3 3 3 3 1 1 1 5 5 5 5 5 5 5 1 1 3 3 3 3 3 3 3 3 3 3 1 1 1 1 3 3 3 3 3 3 3 3 3 3 3 0 0 0 
0 0 0 0 0 0 0 0 0 0 0 0 0 0 3 3 3 3 3 3 1 1 1 1 1 1 1 1 1 1 3 3 3 3 0 0 3 3 3 3 3 1 1 3 3 3 3 3 3 3 3 3 3 3 3 0 0 0 
0 0 0 0 0 0 0 0 0 0 0 0 0 0 0 3 3 3 3 3 3 3 3 3 3 3 3 3 3 3 3 3 3 0 0 0 0 3 3 3 3 3 3 3 3 3 3 3 3 3 3 3 3 3 0 0 0 0 
0 0 0 0 0 0 0 0 0 0 0 0 0 0 0 0 0 0 3 3 3 3 3 3 3 3 3 3 3 3 3 3 0 0 0 0 0 0 0 3 3 3 3 3 3 3 3 0 0 0 0 0 0 0 0 0 0 0 
0 0 0 0 0 0 0 0 0 0 0 0 0 0 0 0 0 0 0 0 0 0 0 0 0 0 0 0 0 0 0 0 0 0 0 0 0 0 0 0 0 0 0 0 0 0 0 0 0 0 0 0 0 0 0 0 0 0
3
3
0 29 26
1 7 50
1 25 8
13
3 5 31
5 7 21
5 13 16
5 19 5
5 20 21
5 21 34
5 23 14
5 31 20
5 28 31
5 27 35
5 14 25
6 5 6
6 33 41
3
0 5 31
1 31 46
1 12 5
7
5 8 37
5 12 43
5 7 21
5 27 6
6 27 34
6 29 25
7 6 49
3
0 15 13
1 31 45
1 30 39
10
5 6 44
5 12 48
5 17 51
5 4 51
5 13 54
5 5 41
5 4 6
5 31 28
5 22 54
6 9 36