48 34
0 0 0 0 0 0 0 0 0 0 0 0 0 0 0 0 0 0 0 0 0 0 0 0 0 0 0 0 0 0 0 0 0 0
0 0 0 0 3 3 3 3 3 3 3 3 3 3 3 3 0 0 0 0 0 0 0 0 0 0 0 0 0 0 0 0 0 0
0 0 0 3 3 3 3 3 3 3 3 3 3 3 3 3 0 0 0 0 0 0 0 0 0 0 0 0 0 0 0 0 0 0
0 0 3 3 3 3 1 1 1 1 1 1 1 1 3 3 3 3 3 3 3 3 3 3 3 3 3 0 0 0 0 0 0 0
0 3 3 3 3 1 1 1 1 1 1 1 1 1 3 3 3 3 3 3 3 3 3 3 3 3 3 3 0 0 0 0 0 0
0 3 3 3 1 1 1 1 1 1 1 1 1 1 3 1 1 1 3 3 3 1 1 1 1 3 3 3 0 0 0 0 0 0
0 3 3 1 1 1 1 1 1 1 1 1 1 1 1 1 1 1 1 1 1 1 1 1 1 1 3 3 0 0 0 0 0 0
0 3 3 1 1 1 1 3 3 3 1 1 1 1 1 1 1 1 1 1 1 1 1 1 1 1 3 3 0 0 0 0 0 0
0 3 3 1 1 1 3 3 3 3 1 1 1 1 1 1 1 1 1 1 1 1 1 1 1 1 3 3 0 0 0 0 0 0
0 3 3 1 1 1 3 3 3 3 1 1 1 1 1 1 1 1 1 1 1 1 1 1 3 3 3 3 3 3 3 3 0 0
0 3 3 1 1 1 3 3 3 3 1 1 1 1 1 1 1 1 1 1 1 1 3 3 3 3 3 3 3 3 3 3 3 0
0 3 3 1 1 3 3 3 3 3 1 1 1 1 1 1 1 1 1 3 3 3 3 3 3 3 3 1 1 1 3 3 3 0
0 3 3 3 3 3 3 3 3 1 1 1 1 1 1 1 3 3 3 3 3 3 3 3 3 3 1 1 1 1 1 3 3 0
0 3 3 3 3 3 3 3 3 1 1 1 1 1 1 1 3 3 3 3 3 3 3 3 3 1 1 1 1 1 1 3 3 0
0 0 0 0 0 0 0 3 3 1 1 1 1 2 1 1 1 1 1 1 1 1 3 3 1 1 1 1 1 1 1 3 3 0
0 0 0 0 0 0 3 3 3 1 1 1 5 5 5 5 5 5 5 5 5 1 1 1 1 1 1 1 1 1 3 3 3 0
0 0 0 0 0 3 3 3 3 1 1 1 5 5 5 5 5 5 5 5 5 1 1 1 1 1 1 1 1 1 3 3 3 0
0 0 0 0 0 3 3 3 1 1 5 5 5 5 5 5 5 5 5 5 5 1 1 1 1 1 1 1 3 3 3 3 0 0
0 0 0 0 3 3 3 1 1 5 5 5 5 5 5 5 5 5 5 5 5 2 1 1 1 1 1 3 3 3 3 3 0 0
0 0 0 3 3 3 3 1 5 5 5 5 5 5 5 5 5 5 5 5 5 1 1 1 1 1 3 3 3 3 0 0 0 0
0 0 0 3 3 3 1 1 5 5 5 5 5 5 5 1 1 1 5 5 5 1 1 1 1 1 3 3 3 0 0 0 0 0
0 0 0 3 3 1 1 5 5 5 5 5 5 5 1 1 1 1 1 5 5 1 1 1 1 1 3 3 0 0 0 0 0 0
0 0 3 3 3 1 5 5 5 5 5 5 5 1 1 3 3 3 1 1 1 1 1 1 1 1 3 3 0 0 0 0 0 0
0 0 3 3 3 1 5 5 5 5 5 5 1 1 3 3 3 3 3 3 1 1 1 1 1 1 3 3 0 0 0 0 0 0
0 3 3 3 1 1 5 5 5 5 5 1 1 3 3 3 3 3 3 3 1 1 1 1 1 3 3 3 0 0 0 0 0 0
0 3 3 3 1 5 5 5 5 5 1 1 1 3 3 3 3 3 3 3 1 1 1 1 1 3 3 3 0 0 0 0 0 0
0 3 3 1 1 5 5 5 5 5 1 1 1 1 3 3 3 3 3 1 1 1 1 1 3 3 3 0 0 0 0 0 0 0
0 3 3 1 5 5 5 5 5 5 5 5 5 1 3 3 3 3 1 1 1 1 1 1 3 3 3 0 0 0 0 0 0 0
0 3 3 1 5 5 5 5 5 5 5 5 5 1 1 1 1 1 1 1 1 1 1 3 3 3 0 0 0 0 0 0 0 0
0 3 3 1 1 1 5 5 5 5 5 5 5 1 1 1 1 1 1 1 1 1 1 3 3 3 0 0 0 0 0 0 0 0
0 3 3 3 1 1 1 5 5 5 5 5 1 1 1 1 1 1 1 1 1 1 3 3 3 0 0 0 0 0 0 0 0 0
0 3 3 3 3 1 1 1 1 1 2 1 1 1 1 1 1 1 1 1 1 3 3 3 3 0 0 0 0 0 0 0 0 0
0 0 3 3 3 3 3 3 1 1 1 1 1 1 1 1 1 1 1 1 3 3 3 3 3 0 0 0 0 0 0 0 0 0
0 0 0 3 3 3 3 3 1 1 1 1 1 1 1 1 1 2 1 1 3 3 3 3 3 0 0 0 0 0 0 0 0 0
0 0 0 0 0 3 3 3 1 1 1 1 1 1 1 1 5 5 5 1 1 1 3 3 3 3 0 0 0 0 0 0 0 0
0 0 0 0 3 3 3 1 1 1 1 1 1 1 1 1 5 5 5 5 5 1 1 3 3 3 3 0 0 0 0 0 0 0
0 0 0 0 3 3 3 1 1 1 1 1 1 1 1 1 1 5 5 5 5 5 1 1 3 3 3 3 0 0 0 0 0 0
0 0 0 0 3 3 1 1 1 1 1 1 1 1 1 1 1 5 5 5 5 5 5 1 1 3 3 3 0 0 0 0 0 0
0 0 0 3 3 3 1 1 1 1 1 1 1 3 3 1 1 5 5 5 5 5 5 5 1 1 3 3 0 0 0 0 0 0
0 0 0 3 3 3 1 1 1 1 1 1 3 3 3 3 1 5 5 5 5 5 5 5 1 1 3 3 0 0 0 0 0 0
0 0 0 3 3 1 1 1 1 1 1 3 3 3 3 3 1 5 5 5 5 5 5 5 1 1 3 3 0 0 0 0 0 0
0 0 0 3 3 1 1 1 1 1 3 3 3 3 3 1 1 5 5 5 5 5 5 5 1 1 3 3 0 0 0 0 0 0
0 0 0 3 3 1 1 1 1 3 3 3 3 3 3 1 5 5 5 5 5 5 5 1 1 3 3 3 0 0 0 0 0 0
0 0 0 3 3 3 3 3 3 3 3 3 0 3 3 1 1 5 5 5 5 5 1 1 3 3 3 3 0 0 0 0 0 0
0 0 0 3 3 3 3 3 3 3 3 0 0 3 3 3 1 1 1 1 1 1 1 3 3 3 3 0 0 0 0 0 0 0
0 0 0 0 0 0 0 0 0 0 0 0 0 3 3 3 3 3 3 3 3 3 3 3 3 3 0 0 0 0 0 0 0 0
0 0 0 0 0 0 0 0 0 0 0 0 0 0 3 3 3 3 3 3 3 3 3 3 3 0 0 0 0 0 0 0 0 0
0 0 0 0 0 0 0 0 0 0 0 0 0 0 0 0 0 0 0 0 0 0 0 0 0 0 0 0 0 0 0 0 0 0
3
2
0 25 5
1 10 3
4
3 10 28
6 40 20
6 14 9
6 6 22
7
2 5 10 8 1
2 4 12 9 1
2 15 22 10 2
2 14 24 9 1
2 5 14 8 1
3 31 8 11 1
3 29 14 6 1
2
0 10 29
1 41 7
12
5 42 17
5 37 22
5 41 22
5 4 21
5 9 19
5 8 23
5 24 12
5 29 4
5 27 14
5 37 15
5 13 24
5 22 25
10
4 8 13
5 28 19
5 25 22
5 41 5
6 26 19
6 27 21
6 10 3
6 8 4
6 6 3
7 36 17
2
0 38 23
1 8 22
6
3 7 3
5 20 16
5 10 28
5 5 18
5 27 4
5 39 10
9
0 20 19
0 5 13
0 7 11
0 9 10
0 14 9
0 28 14
0 35 7
0 35 9
0 33 8