40 58
0 0 0 0 0 0 0 0 0 0 0 0 0 0 0 0 0 0 0 0 0 0 0 0 0 0 0 0 0 0 0 0 0 0 0 0 0 0 0 0 0 0 0 0 0 0 0 0 0 0 0 0 0 0 0 0 0 0
0 0 0 0 0 0 0 0 0 0 0 3 3 3 3 3 3 3 3 3 3 3 3 3 3 3 3 3 3 3 3 3 3 3 3 3 3 3 3 3 3 3 3 3 3 3 3 0 0 0 0 0 0 0 0 0 0 0
0 0 0 0 0 0 0 3 3 3 3 3 3 3 3 3 3 3 3 3 3 3 3 3 3 3 3 3 3 3 3 3 3 3 3 3 3 3 3 3 3 3 3 3 3 3 3 3 0 0 0 0 0 0 0 0 0 0
0 0 0 0 0 0 3 3 3 3 3 3 3 1 1 1 1 1 1 1 1 1 1 3 3 3 3 3 3 3 3 3 3 1 1 1 1 3 3 3 3 1 1 1 1 3 3 3 3 0 0 0 0 0 0 0 0 0
0 0 0 0 0 0 3 3 3 1 1 1 1 1 5 5 5 5 5 5 5 1 1 1 1 1 1 1 3 3 3 1 1 1 5 5 1 1 1 1 1 1 5 5 1 1 3 3 3 3 0 0 0 0 0 0 0 0
0 0 0 0 0 0 3 3 1 1 5 5 5 5 5 5 5 5 5 5 5 5 5 5 5 5 5 1 1 1 1 1 1 5 5 5 5 1 1 1 5 5 5 5 5 1 1 3 3 3 0 0 0 0 0 0 0 0
0 0 0 0 0 3 3 3 1 1 5 5 5 5 5 5 5 5 5 5 5 5 5 5 5 5 5 1 1 1 1 1 1 5 5 5 5 5 5 5 5 5 5 5 5 1 1 3 3 3 3 0 0 0 0 0 0 0
0 0 0 0 0 3 3 3 1 5 5 5 5 5 5 5 5 5 5 5 5 5 5 5 5 5 5 5 1 1 1 1 1 5 5 5 5 5 5 5 5 5 5 5 5 1 1 3 3 3 3 0 0 0 0 0 0 0
0 0 0 0 3 3 3 1 1 5 5 5 5 5 5 5 5 5 5 5 5 5 5 5 5 5 5 5 5 1 1 1 1 1 5 5 5 5 5 5 5 5 1 1 1 1 3 3 3 3 3 0 0 0 0 0 0 0
0 0 0 3 3 3 3 1 5 5 5 5 5 5 5 1 1 1 1 1 1 1 5 5 5 5 5 5 5 1 1 3 3 1 1 5 5 5 5 5 1 1 1 1 3 3 3 3 3 3 0 0 0 0 0 0 0 0
0 0 0 3 3 3 1 1 1 1 1 1 1 1 1 1 1 1 1 1 1 1 1 5 5 5 5 5 5 1 3 3 3 3 1 1 5 5 5 5 1 1 1 1 3 3 3 3 3 3 0 0 0 0 0 0 0 0
0 3 3 3 3 3 3 1 1 1 1 1 1 1 1 1 1 1 1 1 1 1 1 5 5 5 5 5 5 1 3 3 3 3 3 1 5 5 5 5 5 1 1 1 1 3 3 3 3 3 3 3 0 0 0 0 0 0
0 3 3 3 3 3 3 1 1 1 1 1 1 1 1 1 1 1 1 1 1 1 5 5 5 5 5 5 5 1 3 3 3 3 3 1 5 5 5 5 5 5 5 1 1 1 1 1 3 3 3 3 3 0 0 0 0 0
0 3 3 3 3 3 1 1 1 1 5 5 5 5 5 5 5 5 5 1 1 1 5 5 5 5 5 5 5 1 1 3 3 3 3 1 1 1 5 5 5 5 5 5 5 5 5 1 1 3 3 3 3 3 0 0 0 0
0 3 3 3 1 1 1 1 5 5 5 5 5 5 5 5 5 5 5 5 5 5 5 5 5 5 5 5 5 5 1 3 3 3 3 3 1 1 1 5 5 5 5 5 5 5 5 5 1 1 1 3 3 3 3 3 0 0
0 3 3 1 1 1 5 5 5 5 5 5 5 5 5 5 5 5 5 5 5 5 5 5 5 5 5 5 5 5 1 3 3 3 3 3 3 1 1 5 5 5 5 5 5 5 5 5 5 5 1 1 3 3 3 3 3 0
0 3 3 1 1 5 5 5 5 5 5 5 5 5 5 5 5 5 5 5 5 5 5 5 5 5 5 5 5 1 1 3 3 3 3 3 3 1 1 5 5 5 5 5 5 5 5 5 5 5 5 1 1 3 3 3 3 0
0 3 3 1 5 5 5 5 5 5 5 1 1 1 1 1 1 1 5 5 5 5 5 5 5 5 5 1 1 1 1 3 3 3 3 3 1 1 5 5 5 5 5 5 5 5 5 5 5 5 5 5 1 1 3 3 3 0
0 3 3 1 5 5 5 5 5 1 1 1 1 1 1 1 1 1 5 5 5 5 5 5 1 1 1 1 3 3 3 1 3 3 1 1 1 1 5 5 5 5 5 5 5 5 5 5 5 5 5 5 1 1 1 3 3 0
0 3 3 1 5 5 5 5 1 1 1 1 1 1 1 1 1 5 5 5 5 5 5 1 1 3 3 3 3 3 3 3 1 1 1 5 5 5 5 5 5 5 1 1 1 1 5 5 5 5 5 5 1 1 1 3 3 0
0 3 3 1 5 5 5 5 1 1 1 1 1 1 5 5 5 5 5 5 5 5 1 1 3 3 3 3 3 3 3 3 1 5 5 5 5 5 5 5 5 5 1 1 1 1 1 5 5 5 5 5 1 1 1 3 3 0
0 3 3 1 5 5 5 5 5 1 1 1 5 5 5 5 5 5 5 5 1 1 1 3 3 3 3 3 3 3 3 1 1 5 5 5 5 5 5 5 5 1 1 1 1 1 1 5 5 5 5 5 5 1 1 3 3 0
0 3 3 1 5 5 5 5 5 5 5 5 5 5 5 5 5 5 5 1 1 3 3 3 3 3 3 3 3 3 1 1 5 5 5 5 5 5 5 5 5 1 1 1 1 1 5 5 5 5 5 5 5 1 1 3 3 0
0 3 3 1 5 5 5 5 5 5 5 5 5 5 5 5 5 1 1 1 3 3 3 3 3 1 1 1 1 1 1 1 1 1 5 5 5 5 5 5 5 1 1 1 1 1 5 5 5 5 5 5 5 1 1 3 3 0
0 3 3 1 1 5 5 5 5 5 5 5 5 5 1 1 1 1 1 3 3 3 3 3 1 1 5 5 1 1 1 3 3 1 1 1 1 5 5 5 5 1 1 1 1 1 1 5 5 5 5 5 1 1 3 3 3 0
0 3 3 3 1 1 1 1 1 5 5 5 1 1 1 1 1 1 1 3 3 3 3 1 1 5 5 5 5 1 3 3 3 3 3 3 1 5 5 5 5 5 1 1 3 3 1 1 1 5 5 1 1 1 3 3 3 0
0 3 3 3 3 3 3 1 1 1 5 5 1 1 1 1 1 1 1 1 1 1 1 1 5 5 5 5 5 1 3 3 3 3 3 3 1 1 5 5 5 1 1 1 3 3 3 1 1 1 1 1 1 1 3 3 3 0
0 0 3 3 3 3 3 1 1 1 5 5 5 5 5 1 1 1 1 1 1 5 5 5 5 5 5 5 5 1 3 3 3 3 3 3 1 1 5 5 5 1 1 3 3 3 3 3 1 1 1 1 1 1 1 3 3 0
0 0 3 3 3 3 1 1 5 5 5 5 5 5 5 5 5 5 5 5 5 5 5 5 5 5 5 5 1 1 3 3 3 3 3 1 1 1 5 5 5 1 1 3 3 3 3 3 1 1 1 1 1 1 1 3 3 0
0 3 3 3 3 1 1 1 5 5 5 5 5 5 5 5 5 5 5 5 5 5 5 5 5 5 5 1 1 1 1 3 3 3 3 1 1 5 5 5 5 5 1 1 3 3 3 3 3 3 1 1 1 1 1 3 3 0
0 3 3 3 1 1 1 5 5 5 5 5 5 5 5 5 5 5 5 5 5 5 5 5 5 5 5 1 1 1 1 3 3 1 1 1 5 5 5 5 5 5 5 1 1 1 3 3 3 3 3 3 1 1 1 3 3 0
0 3 3 1 1 1 5 5 5 5 5 5 5 5 5 5 1 1 5 5 5 5 5 5 5 5 5 5 1 1 1 1 1 1 5 5 5 5 5 5 5 5 5 1 1 1 1 3 3 3 3 3 3 3 3 3 3 0
0 3 3 1 1 5 5 5 5 5 5 5 5 5 1 1 1 1 1 5 5 5 5 5 5 5 5 5 5 5 5 5 5 5 5 5 5 5 5 5 5 5 1 1 1 1 1 3 3 3 3 3 3 3 3 3 3 0
0 3 3 1 1 5 5 5 5 5 5 5 5 1 1 1 1 1 1 1 5 5 5 5 5 5 5 5 5 5 5 5 5 5 5 5 5 5 1 1 1 1 1 1 1 1 3 3 3 0 0 0 3 3 3 0 0 0
0 3 3 1 1 1 5 5 5 5 5 5 1 1 3 3 3 1 1 1 5 5 5 5 5 5 5 5 5 5 5 5 5 5 5 5 5 5 1 3 3 3 3 3 3 3 3 3 3 0 0 0 0 0 0 0 0 0
0 3 3 1 1 1 1 5 5 5 1 1 1 3 3 3 3 3 1 1 1 1 5 5 5 5 5 5 5 5 5 5 1 1 1 1 1 1 1 3 3 3 3 3 3 3 3 3 0 0 0 0 0 0 0 0 0 0
0 3 3 3 3 3 1 1 1 1 1 3 3 3 3 3 3 3 3 3 3 1 1 1 1 1 1 1 1 1 1 1 1 3 3 3 3 3 3 3 3 0 0 0 0 0 0 0 0 0 0 0 0 0 0 0 0 0
0 3 3 3 3 3 3 3 3 3 3 3 3 3 3 0 3 3 3 3 3 3 3 3 3 3 3 3 3 3 3 3 3 3 3 3 3 3 3 3 3 0 0 0 0 0 0 0 0 0 0 0 0 0 0 0 0 0
0 0 0 0 3 3 3 3 3 3 3 3 3 3 0 0 0 0 3 3 3 3 3 3 3 3 3 3 3 3 3 3 3 3 3 0 0 0 0 0 0 0 0 0 0 0 0 0 0 0 0 0 0 0 0 0 0 0
0 0 0 0 0 0 0 0 0 0 0 0 0 0 0 0 0 0 0 0 0 0 0 0 0 0 0 0 0 0 0 0 0 0 0 0 0 0 0 0 0 0 0 0 0 0 0 0 0 0 0 0 0 0 0 0 0 0
2
3
0 5 26
1 32 8
1 11 36
11
5 13 46
5 17 4
5 20 33
5 21 15
5 22 46
5 24 26
5 25 28
5 30 42
5 32 5
5 34 22
6 5 42
3
0 24 26
1 24 49
1 20 4
10
5 22 46
5 22 52
5 32 7
5 33 11
5 29 10
5 27 14
5 21 8
5 20 14
6 21 33
6 7 11