41 60
0 0 0 0 0 0 0 0 0 0 0 0 0 0 0 0 0 0 0 0 0 0 0 0 0 0 0 0 0 0 0 0 0 0 0 0 0 0 0 0 0 0 0 0 0 0 0 0 0 0 0 0 0 0 0 0 0 0 0 0 
0 0 0 0 0 3 3 3 3 3 3 3 3 3 3 3 0 0 0 0 0 0 0 0 0 0 0 0 0 0 0 0 0 0 0 0 0 0 0 0 0 0 0 0 0 0 0 0 0 0 0 0 0 0 0 0 0 0 0 0
0 0 0 0 3 3 3 3 3 3 3 3 3 3 3 3 3 3 3 3 3 3 3 3 0 0 0 0 0 0 0 0 0 0 0 0 0 0 0 0 0 0 0 0 0 0 0 0 0 0 0 0 0 0 0 0 0 0 0 0 
0 0 3 3 3 3 3 6 6 6 6 6 6 6 3 3 3 3 3 3 3 3 3 3 3 3 3 0 0 0 0 0 0 0 0 0 0 0 0 0 0 0 0 0 0 0 0 0 0 0 0 0 0 0 0 0 0 0 0 0 
0 3 3 3 3 3 6 6 6 6 6 6 6 6 6 3 3 3 3 3 1 1 3 3 3 3 3 3 3 0 0 0 0 0 0 0 0 0 0 0 0 0 3 3 3 3 3 3 3 3 3 3 3 3 0 0 0 0 0 0 
0 3 3 3 6 6 6 6 6 6 6 6 6 6 6 3 3 3 1 1 1 1 1 1 1 3 3 3 3 3 3 0 0 0 0 0 0 0 0 0 0 3 3 3 3 3 3 3 3 3 3 3 3 3 3 0 0 0 0 0 
0 3 3 6 6 6 6 6 6 6 6 6 6 6 6 6 3 3 1 1 6 1 1 1 1 1 1 3 3 3 3 3 0 0 0 0 0 0 0 0 3 3 3 3 3 3 3 3 3 3 3 3 3 3 3 3 0 0 0 0 
0 3 3 6 6 6 6 6 6 6 6 6 6 6 6 6 6 6 6 6 6 6 6 6 1 1 1 1 1 3 3 3 3 0 0 0 0 0 0 3 3 3 3 3 3 1 1 1 1 1 1 1 3 3 3 3 3 0 0 0 
0 3 3 6 6 6 6 6 6 6 6 6 6 6 6 6 6 6 6 6 6 6 6 6 6 1 1 1 1 1 3 3 3 3 0 0 0 0 0 3 3 3 3 1 1 6 6 6 6 6 6 1 1 1 3 3 3 3 0 0 
0 3 3 6 6 6 6 6 6 6 6 6 6 6 6 6 6 6 6 6 6 6 6 6 6 6 6 1 1 1 3 3 3 3 3 0 0 0 3 3 3 3 1 1 1 6 6 6 6 6 6 6 6 1 3 3 3 3 0 0 
0 3 3 3 6 6 6 6 6 6 6 6 6 6 6 6 6 6 6 6 6 6 6 6 6 6 6 1 1 1 1 3 3 3 3 3 3 3 3 3 3 1 1 1 6 6 6 6 6 6 6 6 6 6 1 3 3 3 0 0
0 3 3 3 3 6 6 6 6 6 6 6 6 6 6 6 3 3 1 1 1 6 6 6 6 6 6 6 6 1 1 1 1 3 3 3 3 3 3 3 3 1 1 1 6 6 6 6 6 6 6 6 6 6 1 3 3 3 0 0 
0 0 3 3 3 3 3 3 6 6 6 6 6 6 6 6 3 3 3 1 1 1 6 6 6 6 6 6 6 6 1 1 1 1 3 3 3 3 3 3 1 1 1 1 1 6 6 6 6 6 6 6 6 6 1 3 3 3 0 0 
0 0 3 3 3 3 3 3 3 3 3 6 6 6 3 3 3 3 3 3 1 1 1 6 6 6 6 6 6 6 1 1 1 1 3 3 3 3 1 1 1 1 6 6 6 6 6 6 6 6 6 6 6 6 1 3 3 3 0 0 
0 0 0 3 3 3 3 3 3 3 3 3 3 3 3 3 3 3 3 3 1 1 1 6 6 6 6 6 6 6 6 6 1 1 1 1 1 1 1 1 6 6 6 6 6 6 6 6 6 6 6 6 6 1 1 3 3 3 0 0 
0 0 0 3 3 3 3 3 3 3 3 3 3 3 3 3 3 3 3 1 1 1 1 1 1 6 6 6 6 6 6 6 6 1 1 1 1 1 1 6 6 6 6 6 6 6 6 6 6 6 6 6 1 1 3 3 3 3 0 0
0 0 0 0 3 3 3 3 3 3 3 3 3 3 3 3 1 1 1 1 1 1 1 1 1 1 1 6 6 6 6 6 6 6 6 1 1 6 6 6 6 6 6 6 6 6 6 6 6 6 1 1 1 3 3 3 3 0 0 0 
0 0 0 0 3 3 3 3 3 3 3 3 3 1 1 1 1 1 1 1 1 1 1 1 1 1 1 1 1 6 6 6 6 6 6 6 6 6 6 6 6 6 6 6 6 6 6 6 6 1 1 1 3 3 3 3 0 0 0 0 
0 0 0 3 3 3 3 3 3 3 3 1 1 1 1 1 1 2 1 1 1 1 1 3 3 1 1 1 1 1 6 6 6 6 6 6 6 6 6 6 6 6 6 6 6 6 6 6 6 1 1 3 3 3 3 0 0 0 0 0 
0 0 0 3 3 3 3 3 3 3 1 1 1 1 1 1 5 5 5 1 1 1 1 3 3 3 3 3 1 1 1 1 6 6 6 6 6 6 6 6 6 6 6 6 6 6 6 6 6 1 3 3 3 3 0 0 0 0 0 0 
0 0 0 3 3 3 3 3 3 1 1 1 1 5 5 5 5 5 5 1 1 1 1 3 3 3 3 3 3 3 1 1 1 6 6 6 6 6 6 6 6 6 6 6 6 6 6 6 6 1 3 3 3 0 0 0 0 0 0 0 
0 0 0 3 3 3 3 3 1 1 1 5 5 5 5 5 5 5 5 5 1 1 3 3 3 3 3 3 3 3 3 1 1 1 6 6 6 6 6 6 6 6 6 6 6 6 6 6 1 1 3 3 3 0 0 0 0 0 0 0
0 0 0 3 3 3 3 3 1 1 5 5 5 5 5 5 5 5 5 5 1 1 3 3 3 3 0 0 0 3 3 3 3 1 1 1 1 1 1 6 6 6 6 6 6 6 6 6 1 1 3 3 3 3 3 3 0 0 0 0 
0 0 0 0 3 3 3 3 1 1 5 5 5 5 5 5 5 5 5 5 5 1 1 3 3 3 0 0 0 0 3 3 3 3 3 3 3 3 1 1 1 6 6 6 6 6 6 6 1 1 3 3 3 3 3 3 3 0 0 0 
0 0 0 0 3 3 3 3 1 1 5 5 5 5 5 5 5 5 5 5 5 1 1 3 3 3 3 0 0 0 0 3 3 3 3 3 3 3 3 3 3 1 1 6 6 6 6 1 1 1 1 3 3 1 3 3 3 3 3 0
0 0 0 0 0 3 3 3 3 1 1 5 5 5 5 5 5 5 5 5 5 5 1 1 3 3 3 3 0 0 0 0 0 0 0 0 3 3 3 3 3 3 1 1 1 1 1 1 1 1 1 1 1 1 1 3 3 3 3 0 
0 0 0 0 0 0 3 3 3 3 3 1 5 5 5 5 5 5 5 5 5 5 1 1 1 3 3 3 3 0 0 0 0 0 0 0 0 0 3 3 3 3 3 1 1 1 1 1 1 5 5 5 5 1 1 1 3 3 3 0 
0 0 0 0 0 0 0 3 3 3 3 3 1 5 5 5 5 5 5 5 5 5 5 1 1 1 3 3 3 3 0 0 0 0 0 0 0 0 0 0 3 3 3 3 1 1 1 5 5 5 5 5 5 5 5 1 1 3 3 0 
0 0 0 0 0 0 0 0 0 3 3 3 3 1 1 5 5 5 5 5 5 5 5 5 1 1 3 3 3 3 3 3 3 0 0 0 0 0 0 0 3 3 3 3 1 1 5 5 5 5 5 5 5 5 5 5 1 3 3 0 
0 0 0 0 0 0 0 0 0 0 3 3 3 3 3 1 1 5 5 5 5 5 5 5 5 1 1 3 3 3 3 3 3 3 3 0 0 0 0 3 3 3 3 1 1 5 5 5 5 5 5 5 5 5 5 5 1 3 3 0 
0 0 0 0 0 0 0 0 0 0 0 3 3 3 3 3 1 1 5 5 5 5 5 5 5 5 1 1 1 1 1 3 3 3 3 3 0 0 0 3 3 3 1 1 1 5 5 5 5 5 5 5 5 5 5 5 1 3 3 0 
0 0 0 0 0 0 0 0 0 0 0 0 3 3 3 3 1 1 5 5 5 5 5 5 5 5 5 5 1 1 1 1 3 3 3 3 0 0 0 3 3 3 1 1 5 5 5 5 5 5 5 5 5 5 5 5 1 3 3 0 
0 0 0 0 0 0 0 0 0 0 0 0 0 0 3 3 3 1 1 5 5 5 5 5 5 5 5 5 5 5 5 1 1 1 3 3 0 0 0 3 3 3 1 1 1 5 5 5 5 5 5 5 5 5 5 5 1 3 3 0 
0 0 0 0 0 0 0 0 0 0 0 0 0 0 3 3 3 3 1 1 1 1 5 5 5 5 5 5 5 5 5 1 1 1 3 3 0 0 0 3 3 3 3 1 1 5 5 5 5 5 5 5 5 5 5 5 1 3 3 0 
0 0 0 0 0 0 0 0 0 0 0 0 0 0 3 3 3 3 3 1 1 1 1 1 5 5 5 5 5 5 5 1 1 3 3 3 0 0 0 3 3 3 3 1 1 5 5 5 5 5 5 5 5 5 5 1 1 3 3 0 
0 0 0 0 0 0 0 0 0 0 0 0 0 0 0 0 0 3 3 3 1 1 1 1 1 5 5 5 5 5 1 1 3 3 3 3 0 0 0 0 3 3 3 3 1 1 1 1 1 1 1 5 5 5 5 1 1 3 3 0 
0 0 0 0 0 0 0 0 0 0 0 0 0 0 0 0 0 0 3 3 3 3 1 1 1 1 1 1 1 1 1 3 3 3 3 0 0 0 0 0 0 3 3 3 3 3 3 3 3 1 1 1 1 1 1 1 1 3 3 0
0 0 0 0 0 0 0 0 0 0 0 0 0 0 0 0 0 0 3 3 3 3 3 3 3 3 3 3 3 3 3 3 3 3 0 0 0 0 0 0 0 0 3 3 3 3 3 3 3 3 3 3 1 1 1 1 3 3 3 0 
0 0 0 0 0 0 0 0 0 0 0 0 0 0 0 0 0 0 0 0 3 3 3 3 3 3 3 3 3 3 3 3 3 0 0 0 0 0 0 0 0 0 0 0 0 0 0 0 3 3 3 3 3 3 3 3 3 3 0 0
0 0 0 0 0 0 0 0 0 0 0 0 0 0 0 0 0 0 0 0 0 0 0 0 0 0 0 0 0 0 0 0 0 0 0 0 0 0 0 0 0 0 0 0 0 0 0 0 0 3 3 3 3 3 3 3 3 3 0 0
0 0 0 0 0 0 0 0 0 0 0 0 0 0 0 0 0 0 0 0 0 0 0 0 0 0 0 0 0 0 0 0 0 0 0 0 0 0 0 0 0 0 0 0 0 0 0 0 0 0 0 0 0 0 0 0 0 0 0 0
1
2
0 7 9
1 30 20
7
5 17 11
5 19 22
5 32 30
5 21 11
5 23 20
5 26 49
6 10 48