66 47
0 0 0 0 0 0 0 0 0 0 0 0 0 0 0 0 0 0 0 0 0 0 0 0 0 0 0 0 0 0 0 0 0 0 0 0 0 0 0 0 0 0 0 0 0 0 0
0 0 0 0 0 0 0 0 0 0 0 0 0 0 0 0 0 0 0 0 0 0 0 0 0 3 3 3 3 3 3 3 3 3 0 0 0 0 0 0 0 0 0 0 0 0 0
0 0 0 0 0 0 0 0 0 0 0 0 0 0 0 0 0 0 0 0 0 0 0 0 3 3 3 3 3 3 3 3 3 3 0 0 0 0 0 0 0 0 0 0 0 0 0
0 0 0 0 0 0 0 0 0 0 0 0 0 0 0 0 0 0 0 0 0 0 0 0 3 3 3 1 1 1 1 1 3 3 0 0 0 0 0 0 0 0 0 0 0 0 0
0 0 0 0 0 0 0 0 0 0 0 0 0 0 0 0 0 0 0 0 0 0 0 0 3 3 1 1 5 5 5 1 3 3 3 3 3 0 0 0 0 0 0 0 0 0 0
0 0 0 0 0 0 0 0 0 0 0 0 0 0 0 0 0 0 0 0 0 0 0 0 3 3 1 5 5 5 5 1 1 3 3 3 3 3 3 3 3 3 3 0 0 0 0
0 0 0 0 0 0 0 0 0 0 0 0 0 0 0 0 0 0 0 0 0 0 0 0 3 3 1 5 5 5 5 5 1 1 3 3 3 3 3 3 3 3 3 3 0 0 0
0 0 0 0 0 0 0 0 0 0 0 0 0 0 0 0 0 0 0 0 0 0 0 0 3 3 1 5 5 5 5 5 5 1 1 1 2 1 1 1 1 3 3 3 0 0 0
0 0 0 0 0 0 0 0 0 0 0 0 0 0 0 0 0 0 0 0 0 0 0 0 3 3 1 1 5 5 5 5 5 5 5 5 5 5 5 5 1 1 3 3 0 0 0
0 0 0 0 0 0 0 0 0 0 0 0 0 0 0 0 0 0 0 0 0 0 0 0 3 3 3 1 5 5 5 5 5 5 5 5 5 5 5 5 5 1 3 3 0 0 0
0 0 0 0 0 3 3 3 3 3 3 3 3 3 3 3 3 3 3 0 0 0 0 0 3 3 3 1 1 1 1 5 5 5 5 5 5 5 5 5 5 1 3 3 0 0 0
0 0 0 3 3 3 3 3 3 3 3 3 3 3 3 3 3 3 3 3 3 3 0 0 0 3 3 3 3 3 1 5 5 5 5 5 5 5 5 5 5 1 3 3 0 0 0
0 0 3 3 3 3 3 1 1 1 1 1 1 1 1 1 1 3 3 3 3 3 3 3 0 3 3 3 3 3 1 1 1 5 5 5 5 5 5 5 5 1 3 3 0 0 0
0 3 3 3 3 1 1 1 5 5 5 5 5 5 5 5 1 1 1 1 3 3 3 3 3 3 3 3 3 3 3 3 1 5 5 5 5 5 5 5 1 1 3 3 0 0 0
0 3 3 3 1 1 5 5 5 5 5 5 5 5 5 5 5 5 5 1 1 1 3 3 3 3 3 3 3 3 3 3 1 1 5 5 5 5 5 1 1 3 3 3 0 0 0
0 3 3 1 1 5 5 5 5 5 5 5 5 5 5 5 5 5 5 5 5 1 1 1 3 3 3 3 3 3 3 3 1 1 5 5 5 5 5 1 3 3 3 3 0 0 0
0 3 3 1 5 5 5 5 5 5 5 5 5 5 5 5 5 5 5 5 5 5 5 1 1 1 3 3 3 3 3 3 1 5 5 5 5 5 5 1 3 3 3 3 0 0 0
0 3 3 1 5 5 5 5 5 5 5 5 5 5 5 5 5 5 5 5 5 5 5 5 5 1 1 3 3 3 3 3 1 5 5 5 5 5 5 1 1 3 3 3 3 0 0
0 3 3 1 1 5 5 5 5 5 5 1 1 5 5 5 5 5 5 5 5 5 5 5 5 5 1 1 3 3 3 1 1 5 5 5 5 5 5 5 1 1 3 3 3 3 0
0 3 3 3 1 1 1 5 5 5 1 1 1 1 1 5 5 5 5 5 5 5 5 5 5 5 5 1 3 3 3 1 5 5 5 5 5 5 5 5 5 1 1 3 3 3 0
0 3 3 3 3 3 1 1 1 1 1 3 3 3 1 1 5 5 5 5 5 5 5 5 5 5 5 1 3 3 3 1 5 5 5 5 5 5 5 5 5 5 1 1 3 3 0
0 0 3 3 3 3 3 3 3 3 3 3 3 3 3 1 1 1 5 5 5 5 5 5 5 5 5 1 3 3 3 1 1 1 1 5 5 5 5 5 5 5 5 1 3 3 0
0 0 0 0 3 3 3 3 3 3 3 3 3 3 3 3 3 1 1 5 5 5 5 5 5 5 5 1 3 3 3 3 3 3 1 1 5 5 5 5 5 5 5 1 3 3 0
0 0 0 0 0 0 0 0 0 3 3 3 3 3 3 3 3 1 1 5 5 5 5 5 5 5 5 1 1 3 3 3 3 3 3 1 1 1 5 5 5 5 5 1 3 3 0
0 0 0 0 0 0 0 0 3 3 3 3 3 3 3 3 1 1 1 5 5 5 5 5 5 5 5 5 1 3 3 3 3 3 3 1 1 1 5 5 5 5 5 1 3 3 0
0 0 0 0 0 0 0 0 3 3 3 6 6 6 6 6 6 1 1 5 5 5 5 5 5 5 5 5 1 3 3 3 3 3 3 1 1 5 5 5 5 5 5 1 3 3 0
0 0 0 0 0 0 0 3 3 3 6 6 6 6 6 6 6 6 1 1 5 5 5 5 5 5 5 5 1 1 3 3 3 3 3 1 5 5 5 5 5 5 1 1 3 3 0
0 0 0 0 0 0 0 3 3 3 6 6 6 6 6 6 6 6 6 1 1 5 5 5 5 5 5 5 5 1 1 3 3 3 3 1 5 5 5 5 5 1 3 3 3 3 0
0 0 0 0 0 0 0 3 3 6 6 6 6 6 6 6 6 6 6 1 1 5 5 5 5 5 5 5 5 5 1 1 3 3 1 1 5 5 5 5 5 1 3 3 3 3 0
0 0 0 0 0 0 0 3 3 6 6 6 6 6 6 6 6 6 6 1 2 5 5 5 5 5 5 5 5 5 5 1 1 1 1 5 5 5 5 5 1 1 3 3 0 0 0
0 0 0 0 0 0 0 3 3 6 6 6 6 6 6 6 6 6 6 1 1 5 5 5 5 5 5 5 5 5 5 5 5 5 5 5 5 5 5 5 1 3 3 3 0 0 0
0 0 0 0 0 0 0 3 3 6 6 6 6 6 6 6 6 6 6 1 1 5 5 5 5 5 1 1 5 5 5 5 5 5 5 5 5 5 5 5 1 3 3 3 0 0 0
0 0 0 0 0 0 0 3 3 6 6 6 6 6 6 6 6 6 6 1 5 5 5 5 5 5 1 1 1 5 5 5 5 5 5 5 5 5 5 1 1 3 3 0 0 0 0
0 0 0 0 0 0 0 3 3 3 6 6 6 6 6 6 6 6 6 1 5 5 5 5 5 5 1 1 1 5 5 5 5 5 5 5 5 5 5 1 3 3 3 0 0 0 0
0 0 0 0 0 0 0 3 3 3 3 6 6 6 6 6 6 6 6 1 5 5 5 5 5 1 1 1 1 1 5 5 5 5 5 5 5 5 1 1 3 3 3 0 0 0 0
0 0 0 0 0 0 0 0 3 3 3 6 6 6 6 6 6 6 1 1 5 5 5 5 5 1 1 1 1 1 5 5 5 5 5 5 5 1 1 3 3 3 0 0 0 0 0
0 0 0 0 0 0 0 0 0 3 3 6 6 6 6 6 6 6 1 5 5 5 5 5 5 1 1 1 1 5 5 5 5 5 5 5 5 1 3 3 3 3 0 0 0 0 0
0 0 0 0 0 0 0 0 0 3 3 1 1 1 2 1 1 1 1 5 5 5 5 5 5 1 1 1 1 5 5 5 5 5 5 5 5 1 3 3 3 3 0 0 0 0 0
0 0 0 0 0 0 0 0 0 3 3 1 5 5 5 5 5 5 5 5 5 5 5 5 5 1 1 1 2 5 5 5 5 5 5 5 5 1 1 3 3 3 3 0 0 0 0
0 0 0 0 0 0 0 0 0 3 3 1 1 5 5 5 5 5 5 5 5 5 5 5 5 5 1 1 1 5 5 5 5 5 5 5 5 5 1 1 3 3 3 3 0 0 0
0 0 0 0 0 0 0 0 0 3 3 3 1 1 5 5 5 5 5 5 5 5 5 5 5 5 1 1 1 5 5 5 5 5 5 5 5 5 5 1 1 3 3 3 0 0 0
0 0 0 0 0 0 0 0 0 3 3 3 1 1 5 5 5 5 5 5 5 5 5 5 5 5 5 1 1 5 5 5 5 5 5 5 5 5 5 5 1 1 3 3 0 0 0
0 0 0 0 0 0 0 0 0 0 3 3 1 5 5 5 5 5 5 5 5 5 5 5 5 5 5 1 1 5 5 5 5 5 5 5 5 5 5 5 5 1 3 3 0 0 0
0 0 0 0 0 0 0 0 0 0 3 3 1 5 5 5 5 5 5 5 5 5 5 5 5 5 5 1 1 5 5 5 5 5 5 5 5 5 5 5 5 1 3 3 0 0 0
0 0 0 0 0 0 0 0 0 0 3 3 1 5 5 5 5 5 5 5 5 5 5 5 5 5 5 1 1 1 5 5 5 5 5 5 5 5 5 5 5 1 3 3 0 0 0
0 0 0 0 0 0 0 0 0 0 3 3 1 5 5 5 5 5 5 5 5 5 5 5 5 5 5 1 1 1 5 5 5 5 5 5 5 5 5 5 5 1 3 3 0 0 0
0 0 0 0 0 0 0 0 0 0 3 3 1 5 5 5 5 5 5 5 5 5 5 5 5 5 5 1 1 1 5 5 5 5 5 5 5 5 5 5 5 1 3 3 0 0 0
0 0 0 0 0 0 0 0 0 0 3 3 1 5 5 5 5 5 5 5 5 5 5 5 5 5 5 1 1 1 1 5 5 5 5 5 5 5 5 5 1 1 3 3 0 0 0
0 0 0 0 0 0 0 0 0 0 3 3 1 1 5 5 5 5 1 1 1 1 1 1 1 5 5 1 1 1 1 5 5 5 5 5 5 5 5 1 1 3 3 3 0 0 0
0 0 0 0 0 0 0 0 0 0 3 3 3 1 1 5 5 5 1 3 3 3 3 3 1 1 1 1 3 3 1 5 5 5 5 5 5 5 1 1 3 3 3 3 0 0 0
0 0 0 0 0 0 0 0 0 0 3 3 3 3 1 1 5 1 1 3 3 3 3 3 3 3 3 3 3 3 1 1 5 5 5 5 5 1 1 3 3 3 3 0 0 0 0
0 0 0 0 0 0 0 0 0 0 0 3 3 3 3 3 3 3 3 3 3 0 3 3 3 3 3 3 3 3 1 1 5 5 5 5 5 1 3 3 3 3 0 0 0 0 0
0 0 0 0 0 0 0 0 0 0 0 0 3 3 3 3 3 3 3 3 3 0 0 0 0 0 3 3 3 3 1 1 5 5 5 5 5 1 3 3 3 0 0 0 0 0 0
0 0 0 0 0 0 0 0 0 0 0 0 0 0 0 0 0 0 0 0 0 0 0 0 0 0 3 3 3 3 1 5 5 5 5 5 5 1 3 3 3 3 3 0 0 0 0
0 0 0 0 0 0 0 0 0 0 0 0 0 0 0 0 0 0 0 0 0 0 0 0 0 3 3 3 1 1 1 5 5 5 5 5 5 1 1 3 3 3 3 0 0 0 0
0 0 0 0 0 0 0 0 0 0 0 0 0 0 0 0 0 0 0 0 0 0 0 0 0 3 3 1 1 5 5 5 5 5 5 5 5 5 1 1 3 3 3 0 0 0 0
0 0 0 0 0 0 0 0 0 0 0 0 0 0 0 0 0 0 0 0 0 0 0 0 0 3 3 1 5 5 5 5 5 5 5 5 5 5 5 1 1 3 3 0 0 0 0
0 0 0 0 0 0 0 0 0 0 0 0 0 0 0 0 0 0 0 0 0 0 0 0 0 3 3 1 5 5 5 5 5 5 5 5 5 5 5 5 1 3 3 0 0 0 0
0 0 0 0 0 0 0 0 0 0 0 0 0 0 0 0 0 0 0 0 0 0 0 0 0 3 3 1 5 5 5 5 5 5 5 5 5 5 5 5 1 3 3 0 0 0 0
0 0 0 0 0 0 0 0 0 0 0 0 0 0 0 0 0 0 0 0 0 0 0 0 0 3 3 1 1 5 5 5 5 5 5 5 5 5 5 5 1 3 3 0 0 0 0
0 0 0 0 0 0 0 0 0 0 0 0 0 0 0 0 0 0 0 0 0 0 0 0 0 3 3 3 1 1 5 5 5 5 5 5 5 5 5 1 1 3 3 0 0 0 0
0 0 0 0 0 0 0 0 0 0 0 0 0 0 0 0 0 0 0 0 0 0 0 0 0 3 3 3 3 1 1 1 5 5 5 5 5 1 1 1 3 3 3 0 0 0 0
0 0 0 0 0 0 0 0 0 0 0 0 0 0 0 0 0 0 0 0 0 0 0 0 0 0 3 3 3 3 3 1 1 1 1 1 1 1 3 3 3 3 3 0 0 0 0
0 0 0 0 0 0 0 0 0 0 0 0 0 0 0 0 0 0 0 0 0 0 0 0 0 0 0 3 3 3 3 3 3 3 3 3 3 3 3 3 3 3 0 0 0 0 0
0 0 0 0 0 0 0 0 0 0 0 0 0 0 0 0 0 0 0 0 0 0 0 0 0 0 0 0 0 3 3 3 3 3 3 3 3 3 3 3 0 0 0 0 0 0 0
0 0 0 0 0 0 0 0 0 0 0 0 0 0 0 0 0 0 0 0 0 0 0 0 0 0 0 0 0 0 0 0 0 0 0 0 0 0 0 0 0 0 0 0 0 0 0
3
0 16 33 1 38 20 1 58 35
0