41 60
0 0 0 0 0 0 0 0 0 0 0 0 0 0 0 0 0 0 0 0 0 0 0 0 0 0 0 0 0 0 0 0 0 0 0 0 0 0 0 0 0 0 0 0 0 0 0 0 0 0 0 0 0 0 0 0 0 0 0 0
0 0 0 0 0 3 3 3 3 3 3 3 3 3 3 3 0 0 0 0 0 0 0 0 0 0 0 0 0 0 0 0 0 0 0 0 0 0 0 0 0 0 0 0 0 0 0 0 0 0 0 0 0 0 0 0 0 0 0 0
0 0 0 0 3 3 3 3 3 3 3 3 3 3 3 3 3 3 3 3 3 3 3 3 0 0 0 0 0 0 0 0 0 0 0 0 0 0 0 0 0 0 0 0 0 0 0 0 0 0 0 0 0 0 0 0 0 0 0 0
0 0 3 3 3 3 3 6 6 6 6 6 6 6 3 3 3 3 3 3 3 3 3 3 3 3 3 0 0 0 0 0 0 0 0 0 0 0 0 0 0 0 0 0 0 0 0 0 0 0 0 0 0 0 0 0 0 0 0 0
0 3 3 3 3 3 6 6 6 6 6 6 6 6 6 3 3 3 3 3 1 1 3 3 3 3 3 3 3 0 0 0 0 0 0 0 0 0 0 0 0 0 3 3 3 3 3 3 3 3 3 3 3 3 0 0 0 0 0 0
0 3 3 3 6 6 6 6 6 6 6 6 6 6 6 3 3 3 1 1 1 1 1 1 1 3 3 3 3 3 3 0 0 0 0 0 0 0 0 0 0 3 3 3 3 3 3 3 3 3 3 3 3 3 3 0 0 0 0 0
0 3 3 6 6 6 6 6 6 6 6 6 6 6 6 6 3 3 1 1 6 1 1 1 1 1 1 3 3 3 3 3 0 0 0 0 0 0 0 0 3 3 3 3 3 3 3 3 3 3 3 3 3 3 3 3 0 0 0 0
0 3 3 6 6 6 6 6 6 6 6 6 6 6 6 6 6 6 6 6 6 6 6 6 1 1 1 1 1 3 3 3 3 0 0 0 0 0 0 3 3 3 3 3 3 1 1 1 1 1 1 1 3 3 3 3 3 0 0 0
0 3 3 6 6 6 6 6 6 6 6 6 6 6 6 6 6 6 6 6 6 6 6 6 6 1 1 1 1 1 3 3 3 3 0 0 0 0 0 3 3 3 3 1 1 6 6 6 6 6 6 1 1 1 3 3 3 3 0 0
0 3 3 6 6 6 6 6 6 6 6 6 6 6 6 6 6 6 6 6 6 6 6 6 6 6 6 1 1 1 3 3 3 3 3 0 0 0 3 3 3 3 1 1 1 6 6 6 6 6 6 6 6 1 3 3 3 3 0 0
0 3 3 3 6 6 6 6 6 6 6 6 6 6 6 6 6 6 6 6 6 6 6 6 6 6 6 1 1 1 1 3 3 3 3 3 3 3 3 3 3 1 1 1 6 6 6 6 6 6 6 6 6 6 1 3 3 3 0 0
0 3 3 3 3 6 6 6 6 6 6 6 6 6 6 6 3 3 1 1 1 6 6 6 6 6 6 6 6 1 1 1 1 3 3 3 3 3 3 3 3 1 1 1 6 6 6 6 6 6 6 6 6 6 1 3 3 3 0 0
0 0 3 3 3 3 3 3 6 6 6 6 6 6 6 6 3 3 3 1 1 1 6 6 6 6 6 6 6 6 1 1 1 1 3 3 3 3 3 3 1 1 1 1 1 6 6 6 6 6 6 6 6 6 1 3 3 3 0 0
0 0 3 3 3 3 3 3 3 3 3 6 6 6 3 3 3 3 3 3 1 1 1 6 6 6 6 6 6 6 1 1 1 1 3 3 3 3 1 1 1 1 6 6 6 6 6 6 6 6 6 6 6 6 1 3 3 3 0 0
0 0 0 3 3 3 3 3 3 3 3 3 3 3 3 3 3 3 3 3 1 1 1 6 6 6 6 6 6 6 6 6 1 1 1 1 1 1 1 1 6 6 6 6 6 6 6 6 6 6 6 6 6 1 1 3 3 3 0 0
0 0 0 3 3 3 3 3 3 3 3 3 3 3 3 3 3 3 3 1 1 1 1 1 1 6 6 6 6 6 6 6 6 1 1 1 1 1 1 6 6 6 6 6 6 6 6 6 6 6 6 6 1 1 3 3 3 3 0 0
0 0 0 0 3 3 3 3 3 3 3 3 3 3 3 3 1 1 1 1 1 1 1 1 1 1 1 6 6 6 6 6 6 6 6 1 1 6 6 6 6 6 6 6 6 6 6 6 6 6 1 1 1 3 3 3 3 0 0 0
0 0 0 0 3 3 3 3 3 3 3 3 3 1 1 1 1 1 1 1 1 1 1 1 1 1 1 1 1 6 6 6 6 6 6 6 6 6 6 6 6 6 6 6 6 6 6 6 6 1 1 1 3 3 3 3 0 0 0 0
0 0 0 3 3 3 3 3 3 3 3 1 1 1 1 1 1 2 1 1 1 1 1 3 3 1 1 1 1 1 6 6 6 6 6 6 6 6 6 6 6 6 6 6 6 6 6 6 6 1 1 3 3 3 3 0 0 0 0 0
0 0 0 3 3 3 3 3 3 3 1 1 1 1 1 1 5 5 5 1 1 1 1 3 3 3 3 3 1 1 1 1 6 6 6 6 6 6 6 6 6 6 6 6 6 6 6 6 6 1 3 3 3 3 0 0 0 0 0 0
0 0 0 3 3 3 3 3 3 1 1 1 1 5 5 5 5 5 5 1 1 1 1 3 3 3 3 3 3 3 1 1 1 6 6 6 6 6 6 6 6 6 6 6 6 6 6 6 6 1 3 3 3 0 0 0 0 0 0 0
0 0 0 3 3 3 3 3 1 1 1 5 5 5 5 5 5 5 5 5 1 1 3 3 3 3 3 3 3 3 3 1 1 1 6 6 6 6 6 6 6 6 6 6 6 6 6 6 1 1 3 3 3 0 0 0 0 0 0 0
0 0 0 3 3 3 3 3 1 1 5 5 5 5 5 5 5 5 5 5 1 1 3 3 3 3 0 0 0 3 3 3 3 1 1 1 1 1 1 6 6 6 6 6 6 6 6 6 1 1 3 3 3 3 3 3 0 0 0 0
0 0 0 0 3 3 3 3 1 1 5 5 5 5 5 5 5 5 5 5 5 1 1 3 3 3 0 0 0 0 3 3 3 3 3 3 3 3 1 1 1 6 6 6 6 6 6 6 1 1 3 3 3 3 3 3 3 0 0 0
0 0 0 0 3 3 3 3 1 1 5 5 5 5 5 5 5 5 5 5 5 1 1 3 3 3 3 0 0 0 0 3 3 3 3 3 3 3 3 3 3 1 1 6 6 6 6 1 1 1 1 3 3 1 3 3 3 3 3 0
0 0 0 0 0 3 3 3 3 1 1 5 5 5 5 5 5 5 5 5 5 5 1 1 3 3 3 3 0 0 0 0 0 0 0 0 3 3 3 3 3 3 1 1 1 1 1 1 1 1 1 1 1 1 1 3 3 3 3 0
0 0 0 0 0 0 3 3 3 3 1 1 5 5 5 5 5 5 5 5 5 5 1 1 1 3 3 3 3 0 0 0 0 0 0 0 0 0 3 3 3 3 3 1 1 1 1 1 1 5 5 5 5 1 1 1 3 3 3 0
0 0 0 0 0 0 0 3 3 3 3 1 1 5 5 5 5 5 5 5 5 5 5 1 1 1 3 3 3 3 0 0 0 0 0 0 0 0 0 0 3 3 3 3 1 1 1 5 5 5 5 5 5 5 5 1 1 3 3 0
0 0 0 0 0 0 0 0 3 3 3 3 1 1 1 5 5 5 5 5 5 5 5 5 1 1 3 3 3 3 3 3 3 0 0 0 0 0 0 0 3 3 3 3 1 1 5 5 5 5 5 5 5 5 5 5 1 3 3 0
0 0 0 0 0 0 0 0 0 3 3 3 3 3 1 1 1 5 5 5 5 5 5 5 5 1 1 3 3 3 3 3 3 3 3 0 0 0 0 3 3 3 3 1 1 5 5 5 5 5 5 5 5 5 5 5 1 3 3 0
0 0 0 0 0 0 0 0 0 0 3 3 3 3 3 3 1 1 5 5 5 5 5 5 5 5 1 1 1 1 1 3 3 3 3 3 0 0 0 3 3 3 1 1 1 5 5 5 5 5 5 5 5 5 5 5 1 3 3 0
0 0 0 0 0 0 0 0 0 0 0 0 3 3 3 3 1 1 5 5 5 5 5 5 5 5 5 5 1 1 1 1 3 3 3 3 0 0 0 3 3 3 1 1 5 5 5 5 5 5 5 5 5 5 5 5 1 3 3 0
0 0 0 0 0 0 0 0 0 0 0 0 0 0 3 3 3 1 1 5 5 5 5 5 5 5 5 5 5 5 5 1 1 1 3 3 0 0 0 3 3 3 1 1 1 5 5 5 5 5 5 5 5 5 5 5 1 3 3 0
0 0 0 0 0 0 0 0 0 0 0 0 0 0 3 3 3 3 1 1 1 1 5 5 5 5 5 5 5 5 5 1 1 1 3 3 0 0 0 3 3 3 3 1 1 5 5 5 5 5 5 5 5 5 5 5 1 3 3 0
0 0 0 0 0 0 0 0 0 0 0 0 0 0 0 3 3 3 3 1 1 1 1 1 5 5 5 5 5 5 5 1 1 3 3 3 0 0 0 3 3 3 3 1 1 5 5 5 5 5 5 5 5 5 5 1 1 3 3 0
0 0 0 0 0 0 0 0 0 0 0 0 0 0 0 0 0 3 3 3 1 1 1 1 1 5 5 5 5 5 1 1 3 3 3 3 0 0 0 0 3 3 3 3 1 1 1 1 1 1 1 5 5 5 5 1 1 3 3 0
0 0 0 0 0 0 0 0 0 0 0 0 0 0 0 0 0 0 3 3 3 3 1 1 1 1 1 1 1 1 1 3 3 3 3 0 0 0 0 0 0 3 3 3 3 3 3 3 3 1 1 1 1 1 1 1 1 3 3 0
0 0 0 0 0 0 0 0 0 0 0 0 0 0 0 0 0 0 3 3 3 3 3 3 3 3 3 3 3 3 3 3 3 3 0 0 0 0 0 0 0 0 3 3 3 3 3 3 3 3 3 3 1 1 1 1 3 3 3 0
0 0 0 0 0 0 0 0 0 0 0 0 0 0 0 0 0 0 0 0 3 3 3 3 3 3 3 3 3 3 3 3 3 0 0 0 0 0 0 0 0 0 0 0 0 0 0 0 3 3 3 3 3 3 3 3 3 3 0 0
0 0 0 0 0 0 0 0 0 0 0 0 0 0 0 0 0 0 0 0 0 0 0 0 0 0 0 0 0 0 0 0 0 0 0 0 0 0 0 0 0 0 0 0 0 0 0 0 0 3 3 3 3 3 3 3 3 3 0 0
0 0 0 0 0 0 0 0 0 0 0 0 0 0 0 0 0 0 0 0 0 0 0 0 0 0 0 0 0 0 0 0 0 0 0 0 0 0 0 0 0 0 0 0 0 0 0 0 0 0 0 0 0 0 0 0 0 0 0 0
2
2
0 7 9
1 30 20
9
5 17 11
5 19 22
5 32 30
5 21 11
5 23 20
5 26 49
5 23 8
5 34 54
6 10 48
0
2
0 20 13
1 10 42
10
3 3 20
5 2 7
5 12 11
5 25 43
5 11 26
5 18 36
5 11 49
5 36 55
6 31 52
6 33 29
0
