40 58
0 0 0 0 0 0 0 0 0 0 0 0 0 0 0 0 0 0 0 0 0 0 0 0 0 0 0 0 0 0 0 0 0 0 0 0 0 0 0 0 0 0 0 0 0 0 0 0 0 0 0 0 0 0 0 0 0 0
0 0 0 0 0 0 0 0 0 0 0 3 3 3 3 3 3 3 3 3 3 3 3 3 3 3 3 3 3 3 3 3 3 3 3 3 3 3 3 3 3 3 3 3 3 3 3 0 0 0 0 0 0 0 0 0 0 0
0 0 0 0 0 0 0 3 3 3 3 3 3 3 3 3 3 3 3 3 3 3 3 3 3 3 3 3 3 3 3 3 3 3 3 3 3 3 3 3 3 3 3 3 3 3 3 3 0 0 0 0 0 0 0 0 0 0
0 0 0 0 0 0 3 3 3 3 3 3 3 1 1 1 1 1 1 1 1 1 1 3 3 3 3 3 3 3 3 3 3 1 1 1 1 3 3 3 3 1 1 1 1 3 3 3 3 0 0 0 0 0 0 0 0 0
0 0 0 0 0 0 3 3 3 1 1 1 1 1 5 5 5 5 5 5 5 1 1 1 1 1 1 1 3 3 3 1 1 1 5 5 1 1 1 1 1 1 5 5 1 1 3 3 3 3 0 0 0 0 0 0 0 0
0 0 0 0 0 0 3 3 1 1 5 5 5 5 5 5 5 5 5 5 5 5 5 5 5 5 5 1 1 1 1 1 1 5 5 5 5 1 1 1 5 5 5 5 5 1 1 3 3 3 0 0 0 0 0 0 0 0
0 0 0 0 0 0 3 3 1 1 5 5 5 5 5 5 5 5 5 5 5 5 5 5 5 5 5 1 1 1 1 1 1 5 5 5 5 5 5 5 5 5 5 5 5 1 1 3 3 3 3 0 0 0 0 0 0 0
0 0 0 0 0 3 3 3 1 5 5 5 5 5 5 5 5 5 5 5 5 5 5 5 5 5 5 5 1 1 1 1 1 5 5 5 5 5 5 5 5 5 5 5 5 1 1 3 3 3 3 0 0 0 0 0 0 0
0 0 0 0 3 3 3 1 1 5 5 5 5 5 5 5 5 5 5 5 5 5 5 5 5 5 5 5 5 1 3 3 1 1 5 5 5 5 5 5 5 5 1 1 1 1 3 3 3 3 3 0 0 0 0 0 0 0
0 0 0 3 3 3 3 1 5 5 5 5 5 5 5 1 1 1 1 1 1 1 5 5 5 5 5 5 5 1 3 3 3 1 1 5 5 5 5 5 1 1 1 1 3 3 3 3 3 3 0 0 0 0 0 0 0 0
0 0 0 3 3 1 1 1 1 1 1 1 1 1 1 1 1 1 1 1 1 1 1 5 5 5 5 5 5 1 3 3 3 3 1 1 5 5 5 5 1 1 1 1 3 3 3 3 3 3 0 0 0 0 0 0 0 0
0 3 3 3 3 3 3 1 1 1 1 1 1 1 1 1 1 1 1 1 1 1 1 5 5 5 5 5 5 1 3 3 3 3 3 1 5 5 5 5 5 1 1 1 3 3 3 3 3 3 3 3 0 0 0 0 0 0
0 3 3 3 3 3 3 1 1 1 1 1 1 1 1 1 1 1 1 1 1 1 5 5 5 5 5 5 5 1 3 3 3 3 3 1 1 5 5 5 5 5 5 1 1 1 1 1 3 3 3 3 3 0 0 0 0 0
0 3 3 3 3 3 1 1 1 1 5 5 5 5 5 5 5 5 5 1 1 1 5 5 5 5 5 5 5 1 1 3 3 3 3 3 1 1 5 5 5 5 5 5 5 5 5 1 1 3 3 3 3 3 0 0 0 0
0 3 3 3 1 1 1 1 5 5 5 5 5 5 5 5 5 5 5 5 5 5 5 5 5 5 5 5 5 5 1 3 3 3 3 3 3 1 1 5 5 5 5 5 5 5 5 5 1 1 1 3 3 3 3 3 0 0
0 3 3 1 1 1 5 5 5 5 5 5 5 5 5 5 5 5 5 5 5 5 5 5 5 5 5 5 5 5 1 3 3 3 3 3 3 1 1 5 5 5 5 5 5 5 5 5 5 5 1 1 3 3 3 3 3 0
0 3 3 1 1 5 5 5 5 5 5 5 5 5 5 5 5 5 5 5 5 5 5 5 5 5 5 5 5 1 1 3 3 3 3 3 3 1 1 5 5 5 5 5 5 5 5 5 5 5 5 1 1 3 3 3 3 0
0 3 3 1 5 5 5 5 5 5 5 1 1 1 1 1 1 1 5 5 5 5 5 5 5 5 5 1 1 1 3 3 3 3 3 3 3 1 1 5 5 5 5 5 5 5 5 5 5 5 5 5 1 1 3 3 3 0
0 3 3 1 5 5 5 5 5 1 1 1 1 1 1 1 1 1 5 5 5 5 5 5 1 1 1 1 3 3 3 3 3 3 1 1 1 1 1 5 5 5 5 5 5 5 5 5 5 5 5 5 1 1 1 3 3 0
0 3 3 1 5 5 5 5 1 1 1 1 1 1 1 1 1 5 5 5 5 5 5 1 1 3 3 3 3 3 3 3 1 1 1 5 5 5 5 5 5 5 1 1 1 1 1 5 5 5 5 5 1 1 1 3 3 0
0 3 3 1 5 5 5 5 1 1 1 1 1 1 5 5 5 5 5 5 5 5 1 1 3 3 3 3 3 3 3 3 1 5 5 5 5 5 5 5 5 1 1 1 1 1 1 5 5 5 5 5 1 1 1 3 3 0
0 3 3 1 5 5 5 5 5 1 1 1 5 5 5 5 5 5 5 5 1 1 1 3 3 3 3 3 3 3 3 1 1 5 5 5 5 5 5 5 5 1 1 1 1 1 1 5 5 5 5 5 5 1 1 3 3 0
0 3 3 1 5 5 5 5 5 5 5 5 5 5 5 5 5 5 5 1 1 3 3 3 3 3 3 3 3 3 1 1 5 5 5 5 5 5 5 5 5 1 1 1 1 1 5 5 5 5 5 5 5 1 1 3 3 0
0 3 3 1 5 5 5 5 5 5 5 5 5 5 5 5 5 1 1 1 3 3 3 3 3 1 1 1 1 1 1 1 1 1 5 5 5 5 5 5 5 1 1 1 1 1 5 5 5 5 5 5 5 1 1 3 3 0
0 3 3 1 1 5 5 5 5 5 5 5 5 5 1 1 1 1 1 3 3 3 3 3 1 1 5 5 1 1 1 3 3 1 1 1 1 5 5 5 5 1 1 1 1 1 1 5 5 5 5 5 1 1 3 3 3 0
0 3 3 3 1 1 1 1 1 5 5 5 1 1 1 1 1 1 1 3 3 3 3 1 1 5 5 5 5 1 3 3 3 3 3 3 1 5 5 5 5 5 1 1 3 3 1 1 1 5 5 1 1 1 3 3 3 0
0 3 3 3 3 3 3 1 1 1 5 5 1 1 1 1 1 1 1 1 1 1 1 1 5 5 5 5 5 1 3 3 3 3 3 3 1 1 5 5 5 1 1 1 3 3 3 1 1 1 1 1 1 1 3 3 3 0
0 0 3 3 3 3 3 1 1 1 5 5 5 5 5 1 1 1 1 1 1 5 5 5 5 5 5 5 5 1 3 3 3 3 3 3 1 1 5 5 5 1 1 3 3 3 3 3 1 1 1 1 1 1 1 3 3 0
0 0 3 3 3 3 1 1 5 5 5 5 5 5 5 5 5 5 5 5 5 5 5 5 5 5 5 5 1 1 3 3 3 3 3 1 1 1 5 5 5 1 1 3 3 3 3 3 1 1 1 1 1 1 1 3 3 0
0 3 3 3 3 1 1 1 5 5 5 5 5 5 5 5 5 5 5 5 5 5 5 5 5 5 5 1 1 1 3 3 3 3 3 1 1 5 5 5 5 5 1 1 3 3 3 3 3 3 1 1 1 1 1 3 3 0
0 3 3 3 1 1 1 5 5 5 5 5 5 5 5 5 5 5 5 5 5 5 5 5 5 5 5 1 1 1 1 3 3 1 1 1 5 5 5 5 5 5 5 1 1 1 3 3 3 3 3 3 1 1 1 3 3 0
0 3 3 1 1 1 5 5 5 5 5 5 5 5 5 5 1 1 5 5 5 5 5 5 5 5 5 5 1 1 1 1 1 1 5 5 5 5 5 5 5 5 5 5 1 1 1 3 3 3 3 3 3 3 3 3 3 0
0 3 3 1 1 5 5 5 5 5 5 5 5 5 1 1 1 1 1 5 5 5 5 5 5 5 5 5 5 5 5 5 5 5 5 5 5 5 5 5 5 5 5 5 1 1 1 3 3 3 3 3 3 3 3 3 3 0
0 3 3 1 1 5 5 5 5 5 5 5 5 1 1 1 1 1 1 1 5 5 5 5 5 5 5 5 5 5 5 5 5 5 5 5 5 5 1 1 1 1 1 1 1 1 3 3 3 0 0 0 3 3 3 0 0 0
0 3 3 1 1 1 5 5 5 5 5 5 1 1 3 3 3 1 1 1 5 5 5 5 5 5 5 5 5 5 5 5 5 5 5 5 5 5 1 3 3 3 3 3 3 3 3 3 3 0 0 0 0 0 0 0 0 0
0 3 3 1 1 1 1 5 5 5 1 1 1 3 3 3 3 3 1 1 1 1 5 5 5 5 5 5 5 5 5 5 1 1 1 1 1 1 1 3 3 3 3 3 3 3 3 3 0 0 0 0 0 0 0 0 0 0
0 3 3 3 3 3 1 1 1 1 1 3 3 3 3 3 3 3 3 3 3 1 1 1 1 1 1 1 1 1 1 1 1 3 3 3 3 3 3 3 3 0 0 0 0 0 0 0 0 0 0 0 0 0 0 0 0 0
0 3 3 3 3 3 3 3 3 3 3 3 3 3 3 0 3 3 3 3 3 3 3 3 3 3 3 3 3 3 3 3 3 3 3 3 3 3 3 3 3 0 0 0 0 0 0 0 0 0 0 0 0 0 0 0 0 0
0 0 0 0 3 3 3 3 3 3 3 3 3 3 0 0 0 0 3 3 3 3 3 3 3 3 3 3 3 3 3 3 3 3 3 0 0 0 0 0 0 0 0 0 0 0 0 0 0 0 0 0 0 0 0 0 0 0
0 0 0 0 0 0 0 0 0 0 0 0 0 0 0 0 0 0 0 0 0 0 0 0 0 0 0 0 0 0 0 0 0 0 0 0 0 0 0 0 0 0 0 0 0 0 0 0 0 0 0 0 0 0 0 0 0 0
1
3
0 5 11 0 32 8 1 22 49
0