67 60
0 0 0 0 0 0 0 0 0 0 0 0 0 0 0 0 0 0 0 0 0 0 0 0 0 0 0 0 0 0 0 0 0 0 0 0 0 0 0 0 0 0 0 0 0 0 0 0 0 0 0 0 0 0 0 0 0 0 0 0
0 0 0 0 0 0 0 0 0 0 0 0 0 0 0 0 0 0 0 0 0 0 0 0 0 0 0 0 0 0 0 0 0 0 0 0 0 0 0 0 0 0 0 0 0 0 0 0 3 3 3 3 3 3 0 0 0 0 0 0
0 0 0 0 0 0 0 0 0 0 0 0 0 0 0 0 0 0 0 0 0 0 0 0 0 0 0 0 0 0 0 0 0 0 0 0 0 0 0 0 0 0 0 0 0 0 0 3 3 3 3 3 3 3 3 0 0 0 0 0
0 0 0 0 0 0 0 0 0 0 0 0 0 0 0 0 0 0 0 0 0 0 0 0 0 0 0 0 0 0 0 0 0 0 0 0 0 0 0 0 0 0 0 0 0 0 3 3 3 3 1 1 3 3 3 3 0 0 0 0
0 0 0 0 0 0 0 0 0 0 0 0 0 0 0 0 0 0 0 0 0 0 0 0 0 0 0 0 0 0 0 0 0 0 0 0 0 0 0 0 0 0 0 0 0 0 3 3 3 1 1 1 1 3 3 3 0 0 0 0
0 0 0 0 0 0 0 0 0 0 0 0 0 0 0 0 0 0 0 0 0 0 0 0 0 0 0 0 0 0 0 0 0 0 0 0 0 0 0 0 0 0 0 0 0 3 3 3 1 1 1 1 1 1 3 3 0 0 0 0
0 0 0 0 0 0 0 0 0 0 0 0 0 0 0 0 0 0 0 0 0 0 0 0 0 0 0 0 0 0 0 0 0 0 0 0 0 0 0 0 0 0 0 0 0 3 3 3 1 1 1 1 1 1 3 3 0 0 0 0
0 0 0 0 0 0 0 0 0 0 0 0 0 0 0 0 0 0 0 0 0 0 0 0 0 0 0 0 0 0 0 0 0 0 0 0 0 0 0 0 0 0 0 0 0 3 3 3 1 1 1 1 1 1 3 3 0 0 0 0
0 0 0 0 0 0 0 0 0 0 0 0 0 0 0 0 0 0 0 0 0 0 0 0 0 0 0 0 0 0 0 0 0 0 0 0 0 0 0 0 0 0 0 0 3 3 3 3 1 1 1 1 1 1 3 3 0 0 0 0
0 0 0 0 0 0 0 0 0 0 0 0 0 0 0 0 0 0 0 0 0 0 0 0 0 0 0 0 0 0 0 0 0 0 0 0 0 0 0 0 0 0 3 3 3 3 3 3 3 1 1 1 1 1 3 3 0 0 0 0
0 0 0 0 0 0 0 0 0 0 0 0 0 0 0 0 0 0 0 0 0 0 3 3 3 3 3 3 3 3 3 3 0 0 0 0 0 0 0 0 0 3 3 3 3 3 3 3 3 1 1 2 1 1 3 3 3 0 0 0
0 0 0 0 0 0 0 0 0 0 0 0 0 0 0 0 0 0 0 0 3 3 3 3 3 3 3 3 3 3 3 3 3 0 0 0 0 0 0 0 0 3 3 3 3 3 3 3 3 1 5 5 5 1 3 3 3 0 0 0
0 0 0 0 0 0 0 0 0 0 0 0 0 0 0 0 0 0 3 3 3 3 3 3 1 1 1 1 1 1 3 3 3 3 3 0 0 0 0 0 3 3 3 3 3 3 3 3 3 1 5 5 5 1 1 3 3 3 0 0
0 0 0 0 0 0 0 0 0 0 0 0 0 0 0 0 3 3 3 3 3 3 1 1 1 5 5 5 5 1 1 3 3 3 3 3 0 0 0 3 3 3 3 3 3 3 3 3 3 1 5 5 5 5 1 3 3 3 3 0
0 0 0 0 0 0 0 0 0 0 0 0 0 0 3 3 3 3 3 3 1 1 1 5 5 5 5 5 5 5 1 1 1 3 3 3 3 3 3 3 3 3 3 3 3 3 3 3 3 1 5 5 5 5 1 1 3 3 3 0
0 0 0 0 0 0 0 0 0 0 0 0 0 0 3 3 3 3 1 1 1 5 5 5 5 5 5 5 5 5 5 5 1 3 3 3 3 3 3 3 3 3 3 3 3 3 3 3 3 1 5 5 5 5 5 1 1 3 3 0
0 0 0 0 0 0 0 0 0 0 0 0 0 0 3 3 1 1 1 5 5 5 5 5 5 5 5 5 5 5 5 5 1 1 3 3 3 3 3 3 3 3 3 3 3 3 3 3 3 1 5 5 5 5 5 5 1 3 3 0
0 0 0 0 0 0 0 0 0 0 0 0 0 0 3 3 1 5 5 5 5 5 5 5 5 5 5 5 5 5 5 5 5 1 1 3 3 3 3 3 3 3 3 3 3 3 3 3 1 1 5 5 5 5 5 5 1 3 3 0
0 0 0 0 0 0 0 0 0 0 0 0 0 3 3 3 1 1 5 5 5 5 5 5 5 5 5 5 5 5 5 5 5 5 1 3 3 3 3 3 3 3 3 3 3 3 3 3 1 1 5 5 5 5 5 5 1 3 3 0
0 0 0 0 0 0 0 0 0 0 0 0 3 3 3 3 1 1 5 5 5 5 5 5 5 5 5 5 5 5 5 5 5 5 1 1 3 3 3 3 3 3 3 3 3 3 3 1 1 5 5 5 5 5 5 5 1 3 3 0
0 0 0 0 0 0 0 0 0 0 0 0 3 3 3 1 1 5 5 5 5 5 5 5 5 5 5 5 1 1 1 5 5 5 5 1 1 3 3 3 3 3 3 3 3 3 1 1 5 5 5 5 5 5 5 5 1 3 3 0
0 0 0 0 0 0 0 0 0 0 0 0 3 3 3 1 1 5 5 5 5 5 5 5 5 1 1 1 1 1 1 1 5 5 5 5 1 3 3 3 3 3 3 3 3 3 1 1 5 5 5 5 5 5 5 1 1 3 3 0
0 0 0 0 0 0 0 0 0 0 0 0 3 3 1 1 5 5 5 5 5 5 5 5 1 1 3 3 3 3 3 1 5 5 5 5 1 1 3 3 3 3 3 3 3 1 1 5 5 5 5 1 1 1 1 1 3 3 3 0
0 0 0 0 0 0 0 0 0 0 0 0 3 3 1 5 5 5 5 5 5 5 5 5 1 3 3 3 3 3 3 1 1 5 5 5 5 1 3 3 3 3 3 3 3 1 1 5 5 5 5 1 3 3 3 3 3 3 3 0
0 0 0 0 0 0 0 3 3 3 3 3 3 3 1 5 5 5 5 5 5 5 5 1 1 3 3 3 0 3 3 3 1 5 5 5 5 1 1 3 3 3 3 3 1 1 5 5 5 5 1 1 3 3 3 3 3 3 0 0
0 0 0 0 3 3 3 3 3 3 3 3 3 3 1 5 5 5 5 5 5 1 1 1 3 3 3 0 0 3 3 3 1 1 5 5 5 5 1 1 3 3 3 1 1 1 5 5 5 1 1 3 3 3 0 0 0 0 0 0
0 0 0 3 3 3 3 3 3 1 1 1 1 1 1 1 1 1 2 1 1 1 3 3 3 3 0 0 0 0 3 3 3 1 5 5 5 5 1 1 1 1 1 1 1 5 5 5 5 1 3 3 3 3 0 0 0 0 0 0
0 0 0 3 3 3 1 1 1 1 5 5 5 1 1 1 6 6 6 6 1 3 3 3 3 3 0 0 0 0 3 3 3 1 1 5 5 5 5 1 1 1 1 5 5 5 5 5 1 1 3 3 3 0 0 0 0 0 0 0
0 0 0 3 3 1 1 1 5 5 5 5 5 5 1 6 6 6 6 6 6 3 3 3 0 0 0 0 0 0 0 3 3 3 1 5 5 5 5 1 1 1 5 5 5 5 5 5 1 3 3 3 0 0 0 0 0 0 0 0
0 0 0 3 3 1 1 1 5 5 5 5 5 5 1 6 6 6 6 6 6 3 3 0 0 0 0 0 0 0 0 3 3 3 1 1 5 5 5 5 1 1 5 5 5 5 5 1 1 3 3 3 0 0 0 0 0 0 0 0
0 0 0 3 3 1 1 1 5 5 5 5 5 5 2 6 6 6 6 6 6 3 3 0 0 0 0 0 0 0 0 0 3 3 3 1 5 5 5 5 5 5 5 5 5 5 1 1 3 3 3 0 0 0 0 0 0 0 0 0
0 0 0 3 3 1 1 1 1 1 5 5 5 5 1 6 6 6 6 6 6 3 3 0 0 0 0 0 0 0 0 0 3 3 3 1 5 5 5 5 5 5 5 5 5 1 1 3 3 3 3 0 0 0 0 0 0 0 0 0
0 0 0 3 3 3 1 1 1 1 1 5 5 5 1 6 6 6 6 6 3 3 3 0 0 0 0 0 0 0 0 0 0 3 3 1 1 5 5 5 5 5 5 5 5 1 1 3 3 3 3 3 0 0 0 0 0 0 0 0
0 0 0 3 3 3 3 1 1 1 1 5 5 5 1 1 6 6 6 3 3 3 3 0 3 3 3 3 3 3 3 3 3 3 3 1 1 5 5 5 5 5 5 5 5 1 1 3 3 3 3 3 3 3 0 0 0 0 0 0
0 0 0 0 3 3 3 3 3 1 5 5 5 1 1 3 3 3 3 3 3 3 3 3 3 3 3 3 3 3 3 3 3 3 3 1 1 5 5 5 5 5 5 5 5 1 1 6 6 6 3 3 3 3 3 0 0 0 0 0
0 0 0 0 0 3 3 3 3 1 5 5 5 1 3 3 3 3 3 3 3 3 3 3 3 3 1 1 1 1 1 1 1 1 1 1 5 5 5 5 5 5 5 5 1 1 6 6 6 6 6 6 3 3 3 3 0 0 0 0
0 0 0 0 0 0 0 3 3 1 5 5 5 1 3 3 3 3 3 3 3 1 1 1 1 1 1 5 5 5 5 5 1 1 1 5 5 5 5 5 5 5 5 5 1 1 6 6 6 6 6 6 6 3 3 3 3 0 0 0
0 0 0 0 0 0 0 3 3 1 5 5 5 1 3 3 3 3 3 3 3 1 5 5 5 5 5 5 5 5 5 5 5 5 5 5 5 5 5 5 5 5 5 5 2 1 6 6 6 6 6 6 6 6 3 3 3 0 0 0
0 0 0 0 0 0 0 3 3 1 5 5 5 1 1 3 3 3 3 3 3 1 1 5 5 5 5 5 5 5 5 5 5 5 5 5 5 5 5 5 5 5 5 5 1 1 6 6 6 6 6 6 6 6 6 3 3 3 0 0
0 0 0 0 0 0 0 3 3 1 5 5 5 5 1 3 3 3 3 3 3 3 1 5 5 5 5 5 5 5 5 5 5 5 5 5 5 5 5 5 5 5 5 5 1 1 6 6 6 6 6 6 6 6 6 3 3 3 0 0
0 0 0 0 0 0 3 3 3 1 5 5 5 5 1 1 3 3 3 3 3 3 1 1 5 5 5 5 5 5 5 5 5 5 5 5 5 5 5 5 5 5 5 5 5 1 1 6 6 6 6 6 6 6 6 6 3 3 3 0
0 0 0 0 0 3 3 3 3 1 1 5 5 5 5 1 3 3 3 3 3 3 1 1 5 5 5 5 5 5 5 5 5 5 5 5 5 5 5 5 5 5 5 5 5 5 1 6 6 6 6 6 6 6 6 6 3 3 3 0
0 0 0 0 3 3 3 3 3 1 1 5 5 5 5 1 3 3 3 3 3 1 1 5 5 5 5 5 5 5 5 5 5 5 5 5 5 5 5 5 5 5 5 5 5 5 1 6 6 6 3 3 6 6 6 6 6 3 3 0
0 0 3 3 3 3 3 1 1 1 5 5 5 5 5 1 3 3 3 3 3 1 5 5 5 5 5 5 5 5 1 1 1 1 1 1 1 5 5 5 5 5 5 5 5 5 1 1 6 6 3 3 3 3 6 6 6 3 3 0
0 3 3 3 3 3 1 1 5 5 5 5 5 5 1 1 3 3 3 3 3 1 5 5 5 5 5 5 5 1 1 3 3 3 3 3 1 1 1 1 5 5 5 5 5 5 1 1 6 6 3 3 3 3 6 6 6 3 3 0
0 3 3 3 1 1 1 5 5 5 5 5 5 1 1 3 3 3 3 3 3 1 5 5 5 5 5 5 1 1 3 3 3 3 3 3 3 3 3 1 1 5 5 5 5 5 1 1 6 6 6 3 3 3 6 6 6 3 3 0
0 3 3 1 1 5 5 5 5 5 5 5 1 1 3 3 3 3 3 3 3 1 5 5 5 5 5 1 1 3 3 3 3 0 3 3 3 3 3 1 1 5 5 5 5 1 1 1 6 6 6 6 3 3 6 6 6 3 3 0
0 3 3 1 5 5 5 5 5 5 1 1 1 1 3 3 3 3 3 3 3 1 1 5 5 5 1 1 3 3 3 3 0 0 0 0 3 3 3 1 5 5 5 5 1 1 1 6 6 6 6 6 6 6 6 6 6 3 3 0
0 3 3 1 5 5 5 5 5 1 1 1 1 3 3 3 3 3 3 3 3 1 1 1 1 1 1 3 3 3 3 0 0 0 0 0 3 3 1 1 5 5 5 5 1 1 1 6 6 6 6 6 6 6 6 6 6 3 3 0
0 3 3 1 5 5 5 5 1 1 1 1 1 3 3 3 3 3 3 3 3 3 1 1 1 1 1 3 3 3 3 0 0 0 0 3 3 3 1 5 5 5 5 1 1 1 1 6 6 6 6 6 6 6 6 6 3 3 3 0
0 3 3 1 5 5 5 1 1 1 1 1 1 1 1 3 3 3 3 3 3 3 1 1 5 5 1 1 3 3 3 3 0 0 0 3 3 3 1 5 5 5 5 1 1 1 1 1 6 6 6 6 6 6 6 6 3 3 3 0
0 3 3 1 5 5 5 1 1 1 1 1 1 5 1 1 1 1 3 3 3 3 1 1 5 5 5 1 1 3 3 3 3 0 0 3 3 1 1 5 5 5 1 1 1 1 1 1 6 6 6 6 6 6 6 3 3 3 3 0
0 3 3 1 5 5 5 5 5 1 1 1 5 5 5 5 5 1 1 3 3 1 1 5 5 5 5 5 1 1 3 3 3 3 3 3 3 1 5 5 5 5 1 1 1 1 1 1 1 6 6 6 6 6 1 3 3 3 3 0
0 3 3 1 5 5 5 5 5 5 5 5 5 5 5 5 5 5 1 1 1 1 1 5 5 5 5 5 5 1 1 3 3 3 3 3 3 1 5 5 5 5 1 1 1 1 1 1 1 1 4 1 1 1 3 3 3 3 3 0
0 3 3 1 5 5 5 5 5 5 5 5 5 5 5 5 5 5 5 1 1 5 5 5 5 5 5 5 5 5 1 1 1 3 3 3 1 1 5 5 5 5 1 1 1 1 1 1 5 5 5 5 1 3 3 3 3 3 0 0
0 3 3 1 1 5 5 5 5 5 5 5 5 5 5 5 5 5 5 5 5 5 5 5 5 5 5 5 5 5 5 1 1 1 1 1 1 5 5 5 5 5 5 1 1 1 5 5 5 5 5 5 1 3 3 3 0 0 0 0
0 3 3 3 1 1 1 5 5 5 5 5 5 1 1 1 5 5 5 5 5 5 5 5 5 1 1 5 5 5 5 5 5 1 1 1 5 5 5 5 5 5 5 5 5 5 5 5 5 5 5 5 1 3 3 0 0 0 0 0
0 3 3 3 3 3 1 1 1 1 1 1 1 1 1 1 1 5 5 5 5 5 5 5 1 1 1 1 5 5 5 5 5 5 5 5 5 5 5 5 5 5 5 5 5 5 5 5 5 5 5 1 1 3 3 0 0 0 0 0
0 0 3 3 3 3 3 3 3 3 3 3 3 3 3 3 1 1 5 5 5 5 1 1 1 1 1 1 1 5 5 5 5 5 5 5 5 5 5 5 5 5 5 5 5 5 5 5 1 1 1 1 3 3 3 0 0 0 0 0
0 0 0 0 3 3 3 3 3 3 3 3 3 3 3 3 3 1 1 1 1 1 1 3 3 3 3 3 1 1 5 5 5 5 5 5 5 5 5 5 5 5 5 5 5 5 5 1 1 3 3 3 3 3 3 0 0 0 0 0
0 0 0 0 0 0 0 0 0 0 0 0 0 0 3 3 3 3 3 3 3 3 3 3 3 3 3 3 3 1 5 5 5 5 5 5 5 5 5 5 5 5 5 5 1 1 1 1 3 3 3 3 3 3 0 0 0 0 0 0
0 0 0 0 0 0 0 0 0 0 0 0 0 0 0 3 3 3 3 3 3 3 3 3 3 0 3 3 3 1 1 5 5 5 5 5 5 5 5 5 5 1 1 1 1 3 3 3 3 3 3 0 0 0 0 0 0 0 0 0
0 0 0 0 0 0 0 0 0 0 0 0 0 0 0 0 0 0 0 0 0 0 0 0 0 0 0 3 3 3 1 1 1 5 5 5 5 5 1 1 1 1 3 3 3 3 3 3 3 3 0 0 0 0 0 0 0 0 0 0
0 0 0 0 0 0 0 0 0 0 0 0 0 0 0 0 0 0 0 0 0 0 0 0 0 0 0 3 3 3 3 3 1 1 1 1 1 1 1 3 3 3 3 3 3 3 3 0 0 0 0 0 0 0 0 0 0 0 0 0
0 0 0 0 0 0 0 0 0 0 0 0 0 0 0 0 0 0 0 0 0 0 0 0 0 0 0 0 3 3 3 3 3 3 3 3 3 3 3 3 3 3 3 3 0 0 0 0 0 0 0 0 0 0 0 0 0 0 0 0
0 0 0 0 0 0 0 0 0 0 0 0 0 0 0 0 0 0 0 0 0 0 0 0 0 0 0 0 0 0 3 3 3 3 3 3 3 3 3 3 3 0 0 0 0 0 0 0 0 0 0 0 0 0 0 0 0 0 0 0
0 0 0 0 0 0 0 0 0 0 0 0 0 0 0 0 0 0 0 0 0 0 0 0 0 0 0 0 0 0 0 0 0 0 0 0 0 0 0 0 0 0 0 0 0 0 0 0 0 0 0 0 0 0 0 0 0 0 0 0
3
3
0 50 44
1 46 24
1 32 17
18
3 2 50
5 50 25
5 51 13
5 41 14
5 28 8
5 16 19
5 29 39
5 16 55
5 49 39
5 55 46
5 17 32
5 36 27
5 34 51
5 61 33
5 19 46
5 54 34
5 48 10
6 42 55
0
3
0 6 50
1 42 54
1 61 33
19
5 37 23
5 46 23
5 42 27
5 39 26
5 38 30
5 40 32
5 36 27
5 53 5
5 57 21
5 34 10
5 26 15
5 14 23
5 22 23
5 30 36
5 31 46
5 58 46
5 61 37
5 25 40
5 16 48
0
3
0 47 4
1 19 26
1 44 44
10
5 37 23
5 50 45
5 47 54
5 44 48
5 34 50
5 59 43
6 28 5
6 28 45
6 51 24
6 30 19
0
