60 60
0 0 0 0 0 0 0 0 0 0 0 0 0 0 0 0 0 0 0 0 0 0 0 0 0 0 0 0 0 0 0 0 0 0 0 0 0 0 0 0 0 0 0 0 0 0 0 0 0 0 0 0 0 0 0 0 0 0 0 0
0 0 0 0 0 0 0 0 0 0 0 0 0 0 0 0 0 0 0 0 0 0 0 0 0 0 0 0 0 0 0 0 0 0 0 0 0 0 0 0 0 0 0 0 3 3 3 3 3 3 3 3 3 3 3 3 0 0 0 0
0 0 0 0 0 0 0 0 0 0 0 0 0 0 0 0 0 0 0 0 0 0 0 0 0 0 0 0 0 0 0 0 0 0 0 0 0 0 0 0 0 0 3 3 3 3 3 3 3 3 3 3 3 3 3 3 0 0 0 0
0 0 0 0 0 0 0 0 0 0 0 0 0 0 0 0 0 0 0 0 0 0 3 3 3 3 3 3 3 3 3 3 0 0 0 0 0 0 0 0 0 3 3 3 3 3 1 1 1 1 1 1 1 1 3 3 3 0 0 0
0 0 0 0 0 0 0 0 0 0 0 0 0 0 0 0 0 0 0 0 3 3 3 3 3 3 3 3 3 3 3 3 3 0 0 0 0 0 0 0 3 3 3 3 6 6 6 6 1 1 5 5 5 1 3 3 3 0 0 0
0 0 0 0 0 0 0 0 0 0 0 0 0 0 0 0 0 0 3 3 3 3 3 3 1 1 1 1 1 1 3 3 3 3 3 0 0 0 0 0 3 3 3 6 6 6 6 6 6 1 5 5 5 1 1 3 3 3 0 0
0 0 0 0 0 0 0 0 0 0 0 0 0 0 0 0 3 3 3 3 3 3 1 1 1 5 5 5 5 1 1 3 3 3 3 0 0 0 0 0 3 3 6 6 6 6 6 6 6 1 5 5 5 5 1 3 3 3 3 0
0 0 0 0 0 0 0 0 0 0 0 0 0 0 3 3 3 3 3 3 1 1 1 5 5 5 5 5 5 5 1 1 1 3 3 3 0 0 0 0 3 3 6 6 6 6 6 6 6 2 5 5 5 5 1 1 3 3 3 0
0 0 0 0 0 0 0 0 0 0 0 0 0 0 3 3 3 3 1 1 1 5 5 5 5 5 5 5 5 5 5 5 1 3 3 3 3 0 0 0 3 3 6 6 6 6 6 6 6 1 5 5 5 5 5 1 1 3 3 0
0 0 0 0 0 0 0 0 0 0 0 0 0 0 3 3 1 1 1 5 5 5 5 5 5 5 5 5 5 5 5 5 1 1 3 3 3 0 0 0 3 3 6 6 6 6 6 6 6 1 5 5 5 5 5 5 1 3 3 0
0 0 0 0 0 0 0 0 0 0 0 0 0 0 3 3 1 5 5 5 5 5 5 5 5 5 5 5 5 5 5 5 5 1 1 3 3 3 0 3 3 3 3 6 6 6 6 6 6 1 5 5 5 5 5 5 1 3 3 0
0 0 0 0 0 0 0 0 0 0 0 0 0 3 3 3 1 1 5 5 5 5 5 5 5 5 5 5 5 5 5 5 5 5 1 3 3 3 3 3 3 3 3 3 3 6 6 6 1 1 5 5 5 5 5 5 1 3 3 0
0 0 0 0 0 0 0 0 0 0 0 0 3 3 3 3 1 1 5 5 5 5 5 5 5 5 5 5 5 5 5 5 5 5 1 1 3 3 3 3 3 3 3 3 3 3 3 1 1 5 5 5 5 5 5 5 1 3 3 0
0 0 0 0 0 0 0 0 0 0 0 0 3 3 3 1 1 5 5 5 5 5 5 5 5 5 5 5 1 1 1 5 5 5 5 1 1 3 3 3 3 3 3 3 3 3 3 1 5 5 5 5 5 5 5 5 1 3 3 0
0 0 0 0 0 0 0 0 0 0 0 0 3 3 3 1 1 5 5 5 5 5 5 5 5 1 1 1 1 1 1 1 5 5 5 5 1 3 3 3 3 3 3 3 3 3 1 1 5 5 5 5 5 5 5 1 1 3 3 0
0 0 0 0 0 0 0 0 0 0 0 0 3 3 1 1 5 5 5 5 5 5 5 5 1 1 3 3 3 3 3 1 5 5 5 5 1 1 3 3 3 3 3 3 3 3 1 5 5 5 5 1 1 1 1 1 3 3 3 0
0 0 0 0 0 0 0 0 0 0 0 0 3 3 1 5 5 5 5 5 5 5 5 5 1 3 3 3 3 3 3 1 1 5 5 5 5 1 3 3 3 3 3 3 3 1 1 5 5 5 5 1 3 3 3 3 3 3 3 0
0 0 0 0 0 0 0 3 3 3 3 3 3 3 1 5 5 5 5 5 5 5 5 1 1 3 3 3 0 3 3 3 1 5 5 5 5 1 1 3 3 3 3 3 3 1 5 5 5 5 1 1 3 3 3 3 3 3 0 0
0 0 0 0 0 3 3 3 3 3 3 3 3 3 1 5 5 5 5 5 1 1 1 1 3 3 3 0 0 3 3 3 1 1 5 5 5 5 1 3 3 3 3 3 1 1 5 5 5 1 1 3 3 3 0 0 0 0 0 0
0 0 0 0 0 3 3 3 3 1 1 1 1 1 1 1 1 2 1 1 1 3 3 3 3 3 0 0 0 0 3 3 3 1 5 5 5 5 1 1 3 3 1 1 1 5 5 5 5 1 3 3 3 3 0 0 0 0 0 0
0 0 0 0 0 3 3 1 1 1 5 5 5 1 1 1 6 6 6 6 1 3 3 3 3 3 0 0 0 0 3 3 3 1 1 5 5 5 5 1 1 1 1 5 5 5 5 5 1 1 3 3 3 0 0 0 0 0 0 0
0 0 0 0 0 3 3 1 5 5 5 5 5 5 1 6 6 6 6 6 6 3 3 0 0 0 0 0 0 0 0 3 3 3 1 5 5 5 5 1 1 1 5 5 5 5 5 5 1 3 3 3 0 0 0 0 0 0 0 0
0 0 0 0 0 3 3 1 5 5 5 5 5 5 1 6 6 6 6 6 6 3 3 0 0 0 0 0 0 0 0 3 3 3 1 1 5 5 5 5 1 1 5 5 5 5 5 1 1 3 3 3 0 0 0 0 0 0 0 0
0 0 0 0 0 3 3 1 1 5 5 5 5 5 2 6 6 6 6 6 6 3 3 0 0 0 0 0 0 0 0 0 3 3 3 1 5 5 5 5 5 5 5 5 5 5 1 1 3 3 3 0 0 0 0 0 0 0 0 0
0 0 0 0 0 3 3 3 1 1 5 5 5 5 1 6 6 6 6 6 6 3 3 0 0 0 0 0 0 0 0 0 3 3 3 1 5 5 5 5 5 5 5 5 5 1 1 3 3 3 3 0 0 0 0 0 0 0 0 0
0 0 0 0 0 3 3 3 3 1 1 5 5 5 1 6 6 6 6 6 3 3 3 0 0 0 0 0 0 0 0 0 0 3 3 1 1 5 5 5 5 5 5 5 5 1 1 3 3 3 3 3 0 0 0 0 0 0 0 0
0 0 0 0 0 0 3 3 3 1 1 5 5 5 1 1 6 6 6 3 3 3 3 0 3 3 3 3 3 3 3 3 3 3 3 1 1 5 5 5 5 5 5 5 5 1 1 3 3 3 3 3 3 3 0 0 0 0 0 0
0 0 0 0 0 0 0 3 3 1 5 5 5 1 1 3 3 3 3 3 3 3 3 3 3 3 3 3 3 3 3 3 3 3 3 1 1 5 5 5 5 5 5 5 5 1 1 6 6 6 3 3 3 3 3 0 0 0 0 0
0 0 0 0 0 0 0 3 3 1 5 5 5 1 3 3 3 3 3 3 3 3 3 3 3 3 1 1 1 1 1 1 1 1 1 1 5 5 5 5 5 5 5 5 1 1 6 6 6 6 6 6 3 3 3 3 0 0 0 0
0 0 0 0 0 0 0 3 3 1 5 5 5 1 3 3 3 3 3 3 3 1 1 1 1 1 1 5 5 5 5 5 1 1 1 5 5 5 5 5 5 5 5 5 1 1 6 6 6 6 6 6 6 3 3 3 3 0 0 0
0 0 0 0 0 0 0 3 3 1 5 5 5 1 3 3 3 3 3 3 3 1 5 5 5 5 5 5 5 5 5 5 5 5 5 5 5 5 5 5 5 5 5 5 2 1 6 6 6 6 6 6 6 6 3 3 3 0 0 0
0 0 0 0 0 0 0 3 3 1 5 5 5 1 1 3 3 3 3 3 3 1 1 5 5 5 5 5 5 5 5 5 5 5 5 5 5 5 5 5 5 5 5 5 1 1 6 6 6 6 6 6 6 6 6 3 3 3 0 0
0 0 0 0 0 0 0 3 3 1 5 5 5 5 1 3 3 3 3 3 3 3 1 5 5 5 5 5 5 5 5 5 5 5 5 5 5 5 5 5 5 5 5 5 1 1 6 6 6 6 6 6 6 6 6 3 3 3 0 0
0 0 0 0 0 0 3 3 3 1 5 5 5 5 1 1 3 3 3 3 3 3 1 1 5 5 5 5 5 5 5 5 5 5 5 5 5 5 5 5 5 5 5 5 5 1 1 6 6 6 6 6 6 6 6 6 3 3 3 0
0 0 0 0 0 3 3 3 3 1 1 5 5 5 5 1 3 3 3 3 3 3 1 1 5 5 5 5 5 5 5 5 5 5 5 5 5 5 5 5 5 5 5 5 5 5 1 6 6 6 6 6 6 6 6 6 3 3 3 0
0 0 0 0 3 3 3 3 3 1 1 5 5 5 5 1 3 3 3 3 3 1 1 5 5 5 5 5 5 5 5 5 5 5 5 5 5 5 5 5 5 5 5 5 5 5 1 6 6 6 3 3 6 6 6 6 6 3 3 0
0 0 3 3 3 3 3 1 1 1 5 5 5 5 5 1 3 3 3 3 3 1 5 5 5 5 5 5 5 5 1 1 1 1 1 1 1 5 5 5 5 5 5 5 5 5 1 1 6 6 3 3 3 3 6 6 6 3 3 0
0 3 3 3 3 3 1 1 5 5 5 5 5 5 1 1 3 3 3 3 3 1 5 5 5 5 5 5 5 1 1 3 3 3 3 3 1 1 1 1 5 5 5 5 5 5 1 1 6 6 3 3 3 3 6 6 6 3 3 0
0 3 3 3 1 1 1 5 5 5 5 5 5 1 1 3 3 3 3 3 3 1 5 5 5 5 5 5 1 1 3 3 3 3 3 3 3 3 3 1 1 5 5 5 5 5 1 1 6 6 6 3 3 3 6 6 6 3 3 0
0 3 3 1 1 5 5 5 5 5 5 5 1 1 3 3 3 3 3 3 3 1 5 5 5 5 5 1 1 3 3 3 3 0 3 3 3 3 3 1 1 5 5 5 5 1 1 1 6 6 6 6 3 3 6 6 6 3 3 0
0 3 3 1 5 5 5 5 5 5 1 1 1 1 3 3 3 3 3 3 3 1 1 5 5 5 1 1 3 3 3 3 0 0 0 0 3 3 3 1 5 5 5 5 1 1 1 6 6 6 6 6 6 6 6 6 6 3 3 0
0 3 3 1 5 5 5 5 5 1 1 1 1 3 3 3 3 3 3 3 3 1 1 1 1 1 1 3 3 3 3 0 0 0 0 0 3 3 1 1 5 5 5 5 1 1 1 6 6 6 6 6 6 6 6 6 6 3 3 0
0 3 3 1 5 5 5 5 1 1 1 1 1 3 3 3 3 3 3 3 3 3 1 1 1 1 1 3 3 3 3 0 0 0 0 3 3 3 1 5 5 5 5 1 1 1 1 6 6 6 6 6 6 6 6 6 3 3 3 0
0 3 3 1 5 5 5 1 1 1 1 1 1 1 1 3 3 3 3 3 3 3 1 1 5 5 1 1 3 3 3 3 0 0 0 3 3 3 1 5 5 5 5 1 1 1 1 1 6 6 6 6 6 6 6 6 3 3 3 0
0 3 3 1 5 5 5 1 1 1 1 1 1 5 1 1 1 1 3 3 3 3 1 1 5 5 5 1 1 3 3 3 3 0 0 3 3 1 1 5 5 5 1 1 1 1 1 1 6 6 6 6 6 6 6 3 3 3 3 0
0 3 3 1 5 5 5 5 5 1 1 1 5 5 5 5 5 1 1 3 3 1 1 5 5 5 5 5 1 1 3 3 3 3 3 3 3 1 5 5 5 5 1 1 1 1 1 1 1 6 6 6 6 6 1 3 3 3 3 0
0 3 3 1 5 5 5 5 5 5 5 5 5 5 5 5 5 5 1 1 1 1 1 5 5 5 5 5 5 1 1 3 3 3 3 3 3 1 5 5 5 5 1 1 1 1 1 1 1 1 2 1 1 1 3 3 3 3 3 0
0 3 3 1 5 5 5 5 5 5 5 5 5 5 5 5 5 5 5 1 1 5 5 5 5 5 5 5 5 5 1 1 1 3 3 3 1 1 5 5 5 5 1 1 1 1 1 1 5 5 5 5 1 3 3 3 3 3 0 0
0 3 3 1 1 5 5 5 5 5 5 5 5 5 5 5 5 5 5 5 5 5 5 5 5 5 5 5 5 5 5 1 1 1 1 1 1 5 5 5 5 5 5 1 1 1 5 5 5 5 5 5 1 3 3 3 0 0 0 0
0 3 3 3 1 1 1 5 5 5 5 5 5 1 1 1 5 5 5 5 5 5 5 5 5 1 1 5 5 5 5 5 5 1 1 1 5 5 5 5 5 5 5 5 5 5 5 5 5 5 5 5 1 3 3 0 0 0 0 0
0 3 3 3 3 3 1 1 1 1 1 1 1 1 1 1 1 5 5 5 5 5 5 5 1 1 1 1 5 5 5 5 5 5 5 5 5 5 5 5 5 5 5 5 5 5 5 5 5 5 5 1 1 3 3 0 0 0 0 0
0 0 3 3 3 3 3 3 3 3 3 3 3 3 3 3 1 1 5 5 5 5 1 1 1 1 1 1 1 5 5 5 5 5 5 5 5 5 5 5 5 5 5 5 5 5 5 5 1 1 1 1 3 3 3 0 0 0 0 0
0 0 0 0 3 3 3 3 3 3 3 3 3 3 3 3 3 1 1 1 1 1 1 3 3 3 3 3 1 1 5 5 5 5 5 5 5 5 5 5 5 5 5 5 5 5 5 1 1 3 3 3 3 3 3 0 0 0 0 0
0 0 0 0 0 0 0 0 0 0 0 0 0 0 3 3 3 3 3 3 3 3 3 3 3 3 3 3 3 1 5 5 5 5 5 5 5 5 5 5 5 5 5 5 1 1 1 1 3 3 3 3 3 3 0 0 0 0 0 0
0 0 0 0 0 0 0 0 0 0 0 0 0 0 0 3 3 3 3 3 3 3 3 3 3 0 3 3 3 1 1 5 5 5 5 5 5 5 5 5 5 1 1 1 1 3 3 3 3 3 3 0 0 0 0 0 0 0 0 0
0 0 0 0 0 0 0 0 0 0 0 0 0 0 0 0 0 0 0 0 0 0 0 0 0 0 0 3 3 3 1 1 1 5 5 5 5 5 1 1 1 1 3 3 3 3 3 3 3 3 0 0 0 0 0 0 0 0 0 0
0 0 0 0 0 0 0 0 0 0 0 0 0 0 0 0 0 0 0 0 0 0 0 0 0 0 0 3 3 3 3 3 1 1 1 1 1 1 1 3 3 3 3 3 3 3 3 0 0 0 0 0 0 0 0 0 0 0 0 0
0 0 0 0 0 0 0 0 0 0 0 0 0 0 0 0 0 0 0 0 0 0 0 0 0 0 0 0 3 3 3 3 3 3 3 3 3 3 3 3 3 3 3 3 0 0 0 0 0 0 0 0 0 0 0 0 0 0 0 0
0 0 0 0 0 0 0 0 0 0 0 0 0 0 0 0 0 0 0 0 0 0 0 0 0 0 0 0 0 0 3 3 3 3 3 3 3 3 3 3 3 0 0 0 0 0 0 0 0 0 0 0 0 0 0 0 0 0 0 0
0 0 0 0 0 0 0 0 0 0 0 0 0 0 0 0 0 0 0 0 0 0 0 0 0 0 0 0 0 0 0 0 0 0 0 0 0 0 0 0 0 0 0 0 0 0 0 0 0 0 0 0 0 0 0 0 0 0 0 0
3
0 43 44 1 39 23 1 9 25
1
3 2 46