48 42
0 0 0 0 0 0 0 0 0 0 0 0 0 0 0 0 0 0 0 0 0 0 0 0 0 0 0 0 0 0 0 0 0 0 0 0 0 0 0 0 0 0
0 0 0 0 0 0 0 0 3 3 3 3 3 3 3 3 3 0 0 0 0 0 0 0 0 0 3 3 3 3 3 3 3 3 3 0 0 0 0 0 0 0
0 0 0 0 0 0 0 3 3 3 3 3 3 3 3 3 3 3 0 0 0 0 0 0 0 3 3 3 3 3 3 3 3 3 3 3 0 0 0 0 0 0
0 0 0 0 0 0 0 3 3 3 1 1 1 1 1 3 3 3 3 0 0 0 0 3 3 3 3 3 1 1 1 1 1 3 3 3 0 0 0 0 0 0
0 0 0 0 0 0 0 3 3 1 1 5 5 1 1 3 3 3 3 3 3 3 3 3 3 3 3 1 1 5 5 1 1 3 3 3 0 0 0 0 0 0
0 0 0 0 0 0 0 3 3 1 5 5 5 5 1 3 3 3 3 3 3 3 3 3 3 3 1 1 5 5 5 5 1 3 3 3 3 0 0 0 0 0
0 0 0 0 0 0 0 3 3 1 5 5 5 5 1 1 3 3 3 3 1 1 1 3 3 3 1 1 5 5 5 5 1 3 3 3 3 0 0 0 0 0
0 0 0 0 0 0 0 3 3 1 5 5 5 5 1 1 3 3 3 1 1 5 1 3 3 3 3 1 5 5 5 5 1 1 3 3 3 0 0 0 0 0
0 0 0 0 0 0 0 3 3 1 1 5 5 5 1 1 3 3 1 1 5 5 1 3 3 3 3 1 5 5 5 5 1 1 3 3 3 0 0 0 0 0
0 0 0 0 0 0 0 3 3 1 1 5 5 5 5 1 1 1 1 5 5 5 1 3 3 3 3 1 5 5 5 5 1 1 3 3 3 0 0 0 0 0
0 0 0 0 0 0 0 3 3 3 1 1 5 5 5 1 1 1 1 5 5 5 1 1 3 3 3 1 5 5 5 1 1 3 3 3 3 3 0 0 0 0
0 0 0 0 0 0 0 3 3 3 1 1 5 5 5 1 1 1 1 1 5 5 5 1 3 3 3 1 5 5 5 1 1 3 3 3 3 3 0 0 0 0
0 0 0 0 0 0 0 0 3 3 1 1 5 5 5 1 1 1 1 1 5 5 5 1 1 3 3 1 5 5 5 1 1 3 3 3 3 3 3 0 0 0
0 0 0 0 0 0 0 0 3 3 1 1 5 5 5 1 3 3 1 1 5 5 5 5 1 1 1 1 5 5 5 1 1 1 3 3 3 3 3 3 0 0
0 0 0 0 0 0 0 0 3 3 1 1 5 5 1 1 3 3 1 1 1 5 5 5 5 1 1 1 5 5 5 5 1 1 3 3 3 3 3 3 3 0
0 0 0 0 0 0 0 3 3 3 1 5 5 5 1 1 3 3 3 1 1 5 5 5 5 5 5 5 5 5 5 5 1 1 1 3 3 3 3 3 3 0
0 0 0 0 0 0 0 3 3 3 1 5 5 5 1 3 3 3 3 1 1 1 5 5 5 5 5 5 5 5 5 5 5 1 1 1 1 3 3 3 3 0
0 0 0 0 0 0 3 3 3 1 1 5 5 5 1 3 3 3 3 3 1 1 1 5 5 5 5 5 5 5 5 5 5 5 5 1 1 1 3 3 3 0
0 0 0 0 0 0 3 3 3 1 1 5 5 5 1 3 3 3 3 3 3 1 1 1 1 1 5 5 5 5 5 5 5 5 5 5 1 1 1 3 3 0
0 0 0 0 0 3 3 3 1 1 5 5 5 5 1 1 3 3 3 3 3 3 3 1 1 1 1 5 5 5 5 5 5 5 5 5 5 1 1 3 3 0
0 0 0 0 0 3 3 3 1 5 5 5 5 5 1 1 3 3 3 3 3 3 3 3 3 1 1 1 5 5 5 5 5 5 5 5 5 1 1 3 3 0
0 0 0 0 0 3 3 3 1 5 5 5 5 5 1 1 3 3 3 0 3 3 3 3 3 1 1 1 5 5 5 5 5 5 5 5 5 5 1 3 3 0
0 0 0 3 3 3 3 1 1 1 5 5 5 1 1 1 3 3 3 0 3 3 3 3 3 3 3 1 5 5 5 5 5 5 5 5 5 5 1 3 3 0
0 0 3 3 3 3 3 1 1 1 1 1 1 1 1 1 3 3 3 0 0 3 3 3 3 3 3 1 5 5 5 5 5 5 5 5 5 1 1 3 3 0
0 0 3 3 3 3 1 1 1 1 1 1 1 1 1 3 3 3 3 0 0 3 3 3 3 3 3 1 1 2 1 1 1 1 5 5 1 1 3 3 3 0
0 0 3 3 3 1 1 1 1 1 1 1 1 1 1 3 3 3 3 0 3 3 3 3 6 6 6 6 6 6 6 1 1 1 1 1 1 3 3 3 3 0
0 0 3 3 1 1 1 1 1 1 1 1 1 1 3 3 3 3 0 3 3 3 3 6 6 6 6 6 6 6 6 3 3 3 3 3 3 3 3 3 0 0
0 0 3 3 1 1 1 1 1 1 1 1 1 1 3 3 3 0 3 3 3 3 3 6 6 6 6 6 3 3 3 3 3 3 3 3 3 3 3 0 0 0
0 0 3 3 1 1 1 1 1 1 1 1 1 3 3 3 3 3 3 3 3 3 6 6 6 6 6 3 3 3 3 3 3 3 0 0 0 0 0 0 0 0
0 0 3 3 3 1 1 1 4 1 1 1 1 3 3 3 3 3 3 3 3 6 6 6 6 6 3 3 3 3 3 3 0 0 0 0 0 0 0 0 0 0
0 0 3 3 3 1 1 5 5 5 1 1 3 3 3 3 3 3 3 1 1 1 2 1 1 3 3 3 3 3 0 0 0 0 0 0 0 0 0 0 0 0
0 0 3 3 1 1 1 5 5 5 1 3 3 3 3 3 3 1 1 1 5 5 5 5 1 3 3 3 3 0 0 0 0 0 0 0 0 0 0 0 0 0
0 0 3 3 1 1 5 5 5 5 1 3 3 3 3 3 3 1 5 5 5 5 5 5 1 1 1 3 3 0 0 0 0 0 0 0 0 0 0 0 0 0
0 0 3 3 1 1 5 5 5 5 1 3 3 3 3 3 1 1 5 5 5 5 5 5 1 1 1 3 3 0 0 0 0 0 0 0 0 0 0 0 0 0
0 0 3 3 1 1 5 5 5 5 1 3 3 3 3 3 1 5 5 5 5 5 5 5 1 1 1 3 3 3 0 0 0 0 0 0 0 0 0 0 0 0
0 3 3 3 1 1 5 5 5 5 1 3 3 3 3 1 1 5 5 5 5 5 5 5 1 1 1 1 3 3 0 0 0 0 0 0 0 0 0 0 0 0
0 3 3 3 1 1 5 5 5 5 1 1 3 3 1 1 5 5 5 5 5 5 5 5 1 1 1 1 3 3 3 0 0 0 0 0 0 0 0 0 0 0
0 3 3 1 1 1 5 5 5 5 5 1 1 1 1 5 5 5 5 5 5 5 5 5 1 1 1 1 3 3 3 0 0 0 0 0 0 0 0 0 0 0
0 3 3 1 1 1 5 5 5 5 5 1 1 5 5 5 5 5 5 5 5 5 5 5 5 1 1 1 1 3 3 0 0 0 0 0 0 0 0 0 0 0
0 3 3 1 1 5 5 5 5 5 5 5 5 5 5 5 5 5 5 5 5 5 5 5 5 5 1 1 1 3 3 0 0 0 0 0 0 0 0 0 0 0
0 3 3 1 1 5 5 5 5 5 5 5 5 5 5 5 5 5 5 5 5 5 5 5 5 5 1 1 1 3 3 0 0 0 0 0 0 0 0 0 0 0
0 3 3 1 1 1 5 5 5 5 5 5 5 5 5 5 5 5 5 5 5 5 5 5 5 1 1 1 3 3 3 0 0 0 0 0 0 0 0 0 0 0
0 3 3 3 1 1 1 1 1 5 5 5 5 5 5 5 1 1 5 5 5 5 5 1 1 1 1 1 3 3 3 0 0 0 0 0 0 0 0 0 0 0
0 3 3 3 3 3 3 1 1 1 1 1 1 1 1 1 1 1 1 1 1 1 1 1 1 1 1 3 3 3 0 0 0 0 0 0 0 0 0 0 0 0
0 0 3 3 3 3 3 3 3 3 3 3 3 3 1 1 1 1 1 1 1 1 1 1 3 3 3 3 3 3 0 0 0 0 0 0 0 0 0 0 0 0
0 0 0 0 3 3 3 3 3 3 3 3 3 3 3 3 3 3 3 3 3 3 3 3 3 3 3 3 3 0 0 0 0 0 0 0 0 0 0 0 0 0
0 0 0 0 0 0 0 0 0 0 0 0 0 3 3 3 3 3 3 3 3 3 3 3 3 3 0 0 0 0 0 0 0 0 0 0 0 0 0 0 0 0
0 0 0 0 0 0 0 0 0 0 0 0 0 0 0 0 0 0 0 0 0 0 0 0 0 0 0 0 0 0 0 0 0 0 0 0 0 0 0 0 0 0
3
1
0 35 21
14
5 12 14
5 21 12
5 4 12
5 32 6
5 39 5
5 37 10
5 38 13
5 39 25
5 41 22
5 41 18
5 34 17
5 32 18
6 32 25
7 24 8
1
0 19 10
3
5 21 12
5 12 14
5 4 12
1
0 37 28
10
5 32 6
5 39 5
5 37 10
5 38 13
5 39 25
5 41 22
5 41 18
5 34 17
5 43 14
6 32 25