62 46
0 0 0 0 0 0 0 0 0 0 0 0 0 0 0 0 0 0 0 0 0 0 0 0 0 0 0 0 0 0 0 0 0 0 0 0 0 0 0 0 0 0 0 0 0 0
0 0 0 0 0 0 0 0 0 0 0 0 0 0 3 3 3 3 3 3 3 3 3 3 0 0 0 0 0 0 0 0 0 0 0 0 0 0 0 0 0 0 0 0 0 0
0 0 0 0 0 0 0 0 0 0 0 0 0 3 3 3 3 3 3 3 3 3 3 3 3 0 0 0 0 0 0 0 0 0 3 3 3 3 3 3 3 3 0 0 0 0
0 0 0 0 0 0 0 0 0 0 0 0 3 3 3 3 1 1 1 1 1 1 3 3 3 3 0 0 0 0 0 3 3 3 3 3 3 3 3 3 3 3 3 0 0 0
0 0 0 0 0 0 0 0 0 0 0 0 3 3 3 1 1 5 5 5 1 1 1 1 3 3 3 0 0 0 3 3 3 3 3 1 1 1 1 1 3 3 3 3 0 0
0 0 0 0 0 0 0 0 0 0 0 3 3 3 1 1 5 5 5 5 5 1 1 1 3 3 3 3 3 3 3 3 3 1 1 1 5 5 5 1 1 3 3 3 0 0
0 0 0 0 0 0 0 0 0 0 0 3 3 3 1 5 5 5 5 5 5 5 1 1 1 3 3 3 3 3 3 3 1 1 1 5 5 5 5 5 1 3 3 3 0 0
0 0 0 0 0 0 0 0 0 0 0 3 3 1 1 5 5 5 5 5 5 5 1 1 1 1 1 1 1 1 1 1 1 5 5 5 5 5 5 5 1 3 3 3 0 0
0 0 0 0 0 0 0 0 0 0 3 3 3 1 5 5 5 5 5 5 5 5 1 1 1 1 1 1 1 1 1 1 1 5 5 5 5 5 5 5 1 3 3 3 0 0
0 0 0 0 0 0 0 0 0 0 3 3 3 1 5 5 5 5 5 5 5 5 5 1 1 1 1 1 1 1 1 1 1 5 5 5 5 1 1 1 1 3 3 0 0 0
0 0 0 0 0 0 0 0 0 3 3 3 1 1 5 5 5 5 1 1 5 5 5 1 1 1 1 1 1 1 1 1 5 5 5 5 1 1 1 1 1 3 3 0 0 0
0 0 0 0 0 0 0 0 0 3 3 3 1 5 5 5 5 1 1 1 5 5 5 1 1 1 1 1 1 1 1 1 5 5 5 5 1 1 1 1 1 3 3 0 0 0
0 0 0 0 0 0 0 0 0 3 3 1 1 5 5 5 1 1 1 1 1 5 5 5 1 1 1 1 1 1 5 5 5 5 5 1 1 1 1 1 3 3 3 0 0 0
0 0 0 0 0 0 0 0 0 3 3 1 5 5 5 5 1 1 1 1 1 5 5 5 1 1 1 1 1 1 5 5 5 5 1 1 1 1 1 1 3 3 3 0 0 0
0 0 0 0 0 0 0 0 0 3 3 1 5 5 5 1 1 1 1 1 1 5 5 5 1 1 1 1 1 5 5 5 5 5 1 6 6 6 1 3 3 3 3 0 0 0
0 0 0 0 0 0 0 3 3 3 3 1 5 5 5 1 1 1 1 1 1 1 5 5 5 1 1 1 5 5 5 5 5 1 1 6 6 6 6 3 3 3 0 0 0 0
0 0 0 0 0 0 3 3 3 3 3 1 5 5 5 1 1 1 1 1 1 1 5 5 5 1 1 5 5 5 5 5 1 1 6 6 6 6 3 3 3 3 0 0 0 0
0 0 0 0 0 0 3 3 3 1 1 1 5 5 5 1 1 1 1 1 1 1 5 5 5 5 5 5 5 5 5 1 1 6 6 6 6 6 3 3 3 3 0 0 0 0
0 0 0 0 0 0 3 3 1 1 1 1 5 5 5 5 1 1 1 1 1 1 5 5 5 5 5 5 5 5 1 1 6 6 6 6 6 6 3 3 3 0 0 0 0 0
0 0 0 0 0 0 3 3 1 1 1 1 5 5 5 5 1 1 1 1 1 1 5 5 5 5 5 5 5 1 1 6 6 6 6 6 6 3 3 3 3 0 0 0 0 0
0 0 0 0 0 0 3 3 1 1 1 1 5 5 5 5 1 1 1 1 1 1 1 5 5 5 5 5 1 1 6 6 6 6 6 6 6 3 3 3 3 0 0 0 0 0
0 0 0 0 0 0 3 3 1 1 1 1 5 5 5 5 5 1 1 1 1 1 1 5 5 5 5 5 1 6 6 6 6 6 6 6 6 3 3 3 3 0 0 0 0 0
0 0 0 0 0 0 3 3 1 1 1 2 5 5 5 5 5 1 1 1 1 1 1 5 5 5 5 5 1 6 6 6 6 6 6 6 6 6 3 3 3 3 0 0 0 0
0 0 0 0 0 3 3 3 1 1 1 1 5 5 5 5 5 1 1 1 1 1 1 1 1 2 1 1 1 6 6 6 6 6 6 6 6 6 3 3 3 3 0 0 0 0
0 0 3 3 3 3 3 3 1 1 1 1 5 5 5 5 5 2 1 1 1 1 1 1 1 1 6 6 6 6 6 6 6 6 6 6 6 6 3 3 3 3 3 0 0 0
0 3 3 3 3 3 3 1 1 1 1 1 5 5 5 5 5 1 1 1 1 1 1 1 6 6 6 6 6 6 6 6 6 6 6 6 6 1 1 3 3 3 3 3 0 0
0 3 3 3 1 1 1 1 1 1 1 1 5 5 5 5 5 1 1 1 1 1 3 3 6 6 6 6 6 6 6 1 1 1 6 6 1 1 1 3 3 3 3 3 0 0
0 3 3 1 1 1 1 1 1 1 1 1 1 5 5 5 5 1 1 1 1 3 3 3 6 6 6 6 6 6 1 1 5 1 1 1 1 1 1 1 3 3 3 3 3 0
0 3 3 1 5 5 1 1 1 1 1 1 1 5 5 5 1 1 1 1 3 3 3 3 3 6 6 6 6 6 1 5 5 5 5 1 1 1 1 1 1 3 3 3 3 0
0 3 3 1 5 5 5 1 1 4 1 1 5 5 5 5 1 1 1 1 3 3 3 3 3 6 6 6 6 1 1 5 5 5 5 5 1 1 1 1 1 1 3 3 3 0
0 3 3 1 5 5 5 5 5 5 5 5 5 5 5 5 1 1 1 1 1 3 3 3 6 6 6 6 6 1 5 5 5 5 5 5 1 1 1 1 1 1 3 3 3 0
0 3 3 1 5 5 5 5 5 5 5 5 5 5 5 5 1 1 1 1 1 3 3 3 6 6 6 6 1 1 5 5 5 5 5 5 1 1 1 1 1 1 1 3 3 0
0 3 3 1 1 5 5 5 5 5 5 5 5 5 5 5 1 1 1 1 1 6 6 6 6 6 6 6 1 5 5 5 5 5 5 5 5 1 1 1 1 1 1 3 3 0
0 3 3 3 1 1 5 5 5 5 5 5 5 5 5 5 5 1 1 1 6 6 6 6 6 6 1 1 1 5 5 5 1 1 5 5 5 1 1 1 1 1 1 3 3 0
0 3 3 3 3 1 1 5 5 5 5 5 5 5 5 5 5 1 6 6 6 6 6 6 6 6 1 1 5 5 5 5 1 1 5 5 5 1 1 1 1 1 1 3 3 0
0 0 3 3 3 3 1 5 5 5 5 5 5 1 1 1 1 1 6 6 6 6 6 6 6 6 1 5 5 5 5 1 1 1 1 5 5 5 1 1 1 1 3 3 3 0
0 0 0 3 3 3 1 1 5 5 5 5 1 1 6 6 6 1 6 6 6 6 6 6 6 6 1 5 5 5 5 1 6 6 1 5 5 5 1 1 1 1 3 3 3 0
0 0 0 0 3 3 1 1 5 5 5 5 1 6 6 6 6 6 6 6 6 6 6 6 6 1 1 1 1 1 1 1 6 6 1 5 5 5 5 5 1 3 3 3 0 0
0 0 0 0 3 3 1 1 1 5 5 1 1 6 6 6 6 6 6 6 6 6 6 6 6 1 1 1 1 6 6 6 6 6 1 1 5 5 5 5 1 3 3 3 0 0
0 0 0 0 3 3 3 1 1 5 5 1 1 6 6 6 6 6 6 6 6 6 6 6 1 1 1 1 6 6 6 6 6 6 6 1 5 5 5 5 1 3 3 0 0 0
0 0 0 0 3 3 3 1 1 5 5 1 1 6 6 6 6 6 1 1 1 2 1 1 1 1 1 1 6 6 6 6 6 6 6 1 1 5 5 5 1 3 3 0 0 0
0 0 0 0 3 3 1 1 5 5 5 1 6 6 6 6 6 1 1 5 5 5 5 5 1 1 1 6 6 6 6 6 6 6 6 6 1 1 5 5 1 3 3 0 0 0
0 0 0 0 3 3 1 1 5 5 5 1 6 6 6 6 6 1 5 5 5 5 5 5 1 1 6 6 6 6 6 6 6 6 6 6 6 1 5 5 1 3 3 0 0 0
0 0 0 0 3 3 1 1 5 5 5 1 6 6 6 6 6 1 5 5 5 5 5 5 1 6 6 6 6 6 6 6 6 6 6 6 6 1 1 1 1 3 3 0 0 0
0 0 0 0 3 3 1 5 5 5 1 1 6 6 6 6 6 1 5 5 5 5 5 1 1 6 6 6 6 6 6 6 6 6 6 6 1 1 1 3 3 3 3 0 0 0
0 0 0 0 3 3 1 5 5 5 1 6 6 6 6 6 1 1 5 5 5 5 5 1 1 1 1 6 6 6 6 6 6 6 1 1 1 3 3 3 3 3 3 0 0 0
0 0 0 0 3 3 1 5 5 5 1 6 6 6 6 1 1 5 5 5 5 5 5 5 5 1 1 1 1 6 6 6 6 6 1 1 3 3 3 3 3 0 0 0 0 0
0 0 0 0 3 3 1 5 5 5 1 6 6 6 6 1 5 5 5 5 5 5 5 5 5 5 5 1 1 6 6 6 6 1 1 3 3 3 0 0 0 0 0 0 0 0
0 0 0 0 3 3 1 5 5 5 1 6 6 6 1 1 5 5 5 5 5 5 5 5 5 5 5 5 1 1 6 6 6 1 3 3 3 0 0 0 0 0 0 0 0 0
0 0 0 0 3 3 1 5 5 5 1 1 6 1 1 5 5 5 5 1 1 1 1 5 5 5 5 5 5 1 1 1 1 1 3 3 3 0 0 0 0 0 0 0 0 0
0 0 0 0 3 3 1 5 5 5 5 1 1 1 5 5 5 5 1 1 1 1 1 1 1 5 5 5 5 5 1 1 1 3 3 3 0 0 0 0 0 0 0 0 0 0
0 0 0 0 3 3 1 1 5 5 5 1 1 5 5 5 5 5 1 1 3 3 3 1 1 1 5 5 5 5 5 1 1 3 3 3 0 0 0 0 0 0 0 0 0 0
0 0 0 0 3 3 3 1 5 5 5 5 5 5 5 5 5 1 1 1 3 3 3 3 1 1 1 5 5 5 5 1 1 3 3 0 0 0 0 0 0 0 0 0 0 0
0 0 0 0 3 3 3 1 5 5 5 5 5 5 5 5 5 1 1 1 3 3 3 3 3 3 1 1 5 5 5 5 1 3 3 0 0 0 0 0 0 0 0 0 0 0
0 0 0 0 0 3 3 1 1 5 5 5 5 5 5 5 5 1 3 3 3 3 3 3 3 3 1 1 5 5 5 5 1 3 3 0 0 0 0 0 0 0 0 0 0 0
0 0 0 0 0 3 3 3 1 1 5 5 5 5 5 5 5 1 3 3 3 3 0 3 3 3 3 1 5 5 5 5 1 3 3 0 0 0 0 0 0 0 0 0 0 0
0 0 0 0 0 3 3 3 3 1 1 5 5 5 5 5 5 1 3 3 3 0 0 0 3 3 3 1 1 5 5 1 1 3 3 0 0 0 0 0 0 0 0 0 0 0
0 0 0 0 0 0 3 3 3 1 1 1 5 5 5 5 1 1 3 3 0 0 0 0 3 3 3 3 1 1 1 1 3 3 3 0 0 0 0 0 0 0 0 0 0 0
0 0 0 0 0 0 0 3 3 3 3 1 1 1 1 1 1 3 3 3 0 0 0 0 0 3 3 3 3 3 3 3 3 3 3 0 0 0 0 0 0 0 0 0 0 0
0 0 0 0 0 0 0 3 3 3 3 3 3 3 3 3 3 3 3 3 0 0 0 0 0 0 3 3 3 3 3 3 3 3 0 0 0 0 0 0 0 0 0 0 0 0
0 0 0 0 0 0 0 0 0 3 3 3 3 3 3 3 3 3 3 0 0 0 0 0 0 0 0 0 0 0 0 0 0 0 0 0 0 0 0 0 0 0 0 0 0 0
0 0 0 0 0 0 0 0 0 0 0 0 0 0 0 0 0 0 0 0 0 0 0 0 0 0 0 0 0 0 0 0 0 0 0 0 0 0 0 0 0 0 0 0 0 0
4
0 16 9 0 17 25 1 43 31 1 33 41
1
3 5 37