40 64
0 0 0 0 0 0 0 0 0 0 0 0 0 0 0 0 0 0 0 0 0 0 0 0 0 0 0 0 0 0 0 0 0 0 0 0 0 0 0 0 0 0 0 0 0 0 0 0 0 0 0 0 0 0 0 0 0 0 0 0 0 0 0 0
0 0 0 0 0 0 0 0 0 0 0 0 0 0 0 0 0 0 0 0 0 0 0 0 0 3 3 3 3 3 3 3 3 3 3 0 0 0 0 0 0 0 0 0 0 0 0 0 0 3 3 3 3 0 0 0 3 3 3 3 3 3 0 0
0 0 0 0 0 0 0 0 0 0 0 0 0 0 0 0 0 0 0 0 0 3 3 3 3 3 3 3 3 3 3 3 3 3 3 3 3 3 3 0 0 0 0 0 0 0 3 3 3 3 3 3 3 3 3 3 3 3 3 3 3 3 3 0
0 0 0 0 0 0 0 0 0 0 0 0 0 0 0 3 3 3 3 3 3 3 3 3 3 3 3 3 1 1 1 1 3 3 3 3 3 3 3 3 3 3 3 3 3 3 3 3 3 3 3 3 3 3 3 3 3 3 3 3 3 3 3 0
0 0 0 0 0 0 0 0 0 0 0 3 3 3 3 3 3 3 3 3 3 3 3 1 1 1 1 1 1 5 5 1 1 1 1 1 1 3 3 3 3 3 3 3 3 3 3 3 3 1 1 1 1 1 3 3 3 3 3 3 3 3 3 0
0 0 0 0 0 0 0 0 0 3 3 3 3 3 3 3 3 3 3 6 6 6 6 6 1 1 1 5 5 5 5 5 5 1 1 1 1 3 3 3 3 3 6 6 3 3 3 3 3 3 1 1 1 1 1 3 3 3 3 3 3 3 3 0
0 0 0 0 0 0 0 0 0 3 3 3 3 3 6 6 6 6 6 6 6 6 6 6 1 1 5 5 5 5 5 5 5 5 1 1 1 1 1 3 3 6 6 6 6 3 3 3 3 3 1 1 6 6 1 1 1 3 3 3 3 3 0 0
0 0 0 0 0 0 0 0 0 3 3 3 3 6 6 6 6 6 6 6 6 6 6 6 1 1 5 5 5 5 5 5 5 5 1 1 6 6 6 6 6 6 6 6 6 3 3 3 3 3 3 1 6 6 6 1 1 3 3 3 3 3 0 0
0 0 0 0 0 0 0 0 3 3 3 3 6 6 6 6 6 6 6 6 6 6 6 6 1 1 5 5 5 5 5 5 5 1 1 1 6 6 6 6 6 6 6 6 6 6 6 1 3 3 3 1 6 6 6 1 3 3 3 0 0 0 0 0
0 0 0 0 0 0 0 0 3 3 3 3 6 6 6 6 6 6 6 6 6 6 6 6 1 1 5 5 5 5 5 5 1 1 1 6 6 6 6 6 6 6 6 6 6 6 6 1 1 1 1 1 6 6 6 1 3 3 3 0 0 0 0 0
0 0 0 0 0 0 0 0 3 3 3 6 6 6 6 6 6 3 3 6 6 6 6 6 1 1 1 5 5 5 5 1 1 1 1 6 6 6 6 6 6 6 6 6 6 6 1 1 1 1 1 6 6 6 6 1 3 3 0 0 0 0 0 0
0 0 0 0 0 0 0 0 3 3 3 6 6 6 6 6 6 3 3 6 6 6 6 6 6 1 1 1 1 1 1 1 1 6 6 6 6 6 6 6 6 6 1 1 4 1 1 1 1 1 6 6 6 6 1 3 3 3 0 0 0 0 0 0
0 0 0 0 0 0 0 0 3 3 3 6 6 6 6 6 6 6 6 6 6 6 6 6 6 6 1 1 1 1 1 1 6 6 6 6 6 6 6 6 6 6 1 5 5 5 1 1 1 1 6 6 6 1 3 3 3 3 0 0 0 0 0 0
0 0 0 0 0 0 0 0 3 3 6 6 6 6 6 6 6 6 6 6 6 6 6 6 6 6 6 6 6 6 6 6 6 6 6 6 6 6 6 6 6 6 1 5 5 5 5 1 1 6 6 6 6 1 3 3 3 3 3 0 0 0 0 0
0 0 0 0 0 0 0 0 3 3 6 6 6 6 6 6 6 6 6 6 6 6 6 6 6 6 6 6 6 6 6 6 6 6 6 6 6 6 6 6 6 6 1 5 5 5 5 5 1 6 6 6 6 1 1 1 3 3 3 0 0 0 0 0
0 0 0 0 0 3 3 3 3 3 6 6 6 6 6 6 6 1 1 6 6 6 6 6 6 6 6 6 6 6 6 6 6 6 6 6 6 6 6 6 6 6 1 1 5 5 5 5 1 1 1 2 1 1 1 1 1 3 3 0 0 0 0 0
0 0 0 0 0 3 3 3 3 3 1 6 6 6 6 6 1 1 1 1 1 1 6 6 6 6 6 6 6 6 3 3 3 3 6 6 6 6 6 6 6 6 6 1 1 5 5 5 5 5 5 5 5 5 5 5 1 3 3 0 0 0 0 0
0 0 0 0 3 3 3 3 1 1 1 1 1 1 2 1 1 1 5 5 5 1 1 1 6 6 6 6 6 1 3 3 3 3 3 6 6 6 6 6 6 6 6 1 1 1 5 5 5 5 5 5 5 5 5 1 1 3 3 0 0 0 0 0
0 0 0 0 3 3 3 3 1 1 1 5 5 5 5 5 5 5 5 5 5 5 5 1 1 1 1 1 1 1 1 3 3 3 3 6 6 6 6 6 6 6 6 1 1 1 5 5 5 5 5 5 5 5 5 1 1 3 3 0 0 0 0 0
0 0 0 3 3 3 3 1 1 1 5 5 5 5 5 5 5 5 5 5 5 5 5 5 5 1 1 1 1 1 1 1 3 3 6 6 6 6 6 6 6 6 6 1 1 1 5 5 5 5 5 5 5 1 1 1 1 3 3 0 0 0 0 0
0 0 0 3 3 3 3 1 1 1 5 5 5 5 5 5 5 5 5 5 5 5 5 5 5 5 5 1 1 1 1 1 1 1 6 6 6 6 6 6 6 1 1 1 5 5 5 5 5 5 1 1 1 1 1 1 1 3 3 0 0 0 0 0
0 0 0 3 3 3 1 1 1 1 5 5 5 5 5 5 1 1 1 1 5 5 5 5 5 5 5 5 5 5 1 1 1 1 1 6 6 6 6 1 1 1 5 5 5 5 5 5 5 1 1 1 1 6 6 6 1 3 3 0 0 0 0 0
0 0 0 3 3 3 1 1 1 5 5 5 5 5 5 1 1 1 1 1 1 5 5 5 5 5 5 5 5 5 5 5 5 1 1 1 4 1 1 1 5 5 5 5 5 5 5 5 5 1 1 1 6 6 6 6 6 3 3 0 0 0 0 0
0 0 0 3 3 1 1 1 1 5 5 5 5 5 1 1 1 1 1 1 1 1 5 5 5 5 5 5 5 5 5 5 5 5 5 5 5 5 5 5 5 5 5 5 5 5 5 5 1 1 1 6 6 6 6 6 6 3 3 0 0 0 0 0
0 0 0 3 3 1 1 1 5 5 5 5 5 5 1 1 1 1 1 1 1 1 1 5 5 5 5 5 5 5 5 5 5 5 5 5 5 5 5 5 5 5 5 5 5 5 5 5 1 1 6 6 6 6 6 6 3 3 3 0 0 0 0 0
0 0 0 3 3 1 1 1 5 5 5 5 5 1 1 1 1 1 1 1 1 1 1 1 5 5 5 5 5 5 5 5 5 5 5 5 5 5 5 5 5 5 5 5 5 5 5 1 1 6 6 6 6 6 6 3 3 3 3 0 0 0 0 0
0 0 3 3 3 1 1 5 5 5 5 5 1 1 6 6 1 1 1 1 1 6 6 1 1 1 5 5 5 5 5 5 5 5 5 5 5 5 5 5 5 5 5 5 5 5 5 1 1 6 6 6 6 6 6 3 3 3 3 0 0 0 0 0
0 0 3 3 3 1 1 5 5 5 5 5 1 6 6 6 6 3 3 3 6 6 6 6 6 1 1 1 5 5 5 5 5 5 5 5 5 5 5 5 5 5 5 5 5 5 1 1 6 6 6 6 6 6 3 3 3 3 3 0 0 0 0 0
0 3 3 3 1 1 5 5 5 5 5 5 1 6 6 6 3 3 3 3 6 6 6 6 6 6 6 1 1 1 1 1 1 1 1 1 2 1 1 1 5 5 5 5 5 5 1 6 6 6 6 6 6 3 3 3 3 0 0 0 0 0 0 0
0 3 3 1 1 5 5 5 5 5 5 1 1 6 6 6 3 3 3 6 6 6 6 6 6 6 6 1 1 1 1 1 1 1 1 1 1 1 1 1 1 5 5 5 5 1 1 6 6 6 6 6 3 3 3 3 3 0 0 0 0 0 0 0
0 3 3 1 5 5 5 5 5 5 5 1 1 6 6 1 6 6 6 6 6 6 6 6 6 6 6 1 1 1 1 1 1 1 1 1 1 1 1 1 1 5 5 5 5 1 6 6 6 6 6 6 3 3 3 3 0 0 0 0 0 0 0 0
0 3 3 1 5 5 5 5 5 5 5 1 1 1 1 6 6 6 6 6 6 6 6 6 6 6 1 1 1 3 3 3 3 3 3 3 1 1 1 1 1 5 5 5 1 1 6 6 6 6 6 6 1 3 3 0 0 0 0 0 0 0 0 0
0 3 3 1 1 5 5 5 5 5 5 5 5 5 1 6 6 6 6 6 6 6 6 6 3 3 3 3 3 3 3 3 3 3 3 3 3 3 1 1 1 1 5 5 1 1 6 6 6 6 6 1 1 3 3 0 0 0 0 0 0 0 0 0
0 3 3 1 1 1 1 5 5 5 5 5 5 5 1 6 6 6 6 6 6 6 3 3 3 3 3 3 3 3 3 3 3 3 3 3 3 3 1 1 1 1 1 1 1 1 1 6 6 3 3 3 3 3 3 0 0 0 0 0 0 0 0 0
0 3 3 3 3 3 1 1 1 5 5 5 5 5 1 1 6 6 6 6 3 3 3 3 3 3 3 3 3 3 3 3 3 3 0 3 3 3 1 1 1 1 1 1 1 1 1 1 3 3 3 3 3 3 3 0 0 0 0 0 0 0 0 0
0 0 3 3 3 3 3 3 1 1 1 1 1 1 1 1 1 3 3 3 3 3 3 3 3 3 3 3 3 3 0 0 0 0 0 0 3 3 3 1 1 1 1 1 1 1 1 3 3 3 3 3 0 0 0 0 0 0 0 0 0 0 0 0
0 0 0 0 0 3 3 3 3 3 3 3 3 3 3 3 3 3 3 3 3 3 3 3 3 0 0 0 0 0 0 0 0 0 0 0 0 3 3 3 1 1 1 1 1 1 3 3 3 3 3 0 0 0 0 0 0 0 0 0 0 0 0 0
0 0 0 0 0 3 3 3 3 3 3 3 3 3 3 3 3 3 3 3 3 3 3 0 0 0 0 0 0 0 0 0 0 0 0 0 0 0 3 3 3 3 3 3 3 3 3 3 3 3 0 0 0 0 0 0 0 0 0 0 0 0 0 0
0 0 0 0 0 0 0 0 0 0 0 0 0 0 0 0 0 0 0 0 0 0 0 0 0 0 0 0 0 0 0 0 0 0 0 0 0 0 3 3 3 3 3 3 3 3 3 3 0 0 0 0 0 0 0 0 0 0 0 0 0 0 0 0
0 0 0 0 0 0 0 0 0 0 0 0 0 0 0 0 0 0 0 0 0 0 0 0 0 0 0 0 0 0 0 0 0 0 0 0 0 0 0 0 0 0 0 0 0 0 0 0 0 0 0 0 0 0 0 0 0 0 0 0 0 0 0 0
3
3
0 4 51
1 25 17
1 24 52
13
5 17 56
5 35 45
5 34 16
5 20 26
5 20 44
5 31 43
5 13 46
5 9 11
5 4 19
5 18 34
5 17 30
5 4 30
6 4 42
3
0 19 24
1 17 38
1 34 15
18
3 3 23
5 31 52
5 26 16
5 22 19
5 30 28
5 27 42
5 21 46
5 26 29
5 19 10
5 24 12
5 3 50
5 4 54
5 9 53
5 15 22
5 14 32
5 25 5
6 33 12
6 22 53
3
0 31 38
1 32 7
1 8 17
11
5 28 32
5 28 29
5 18 22
5 25 26
5 21 42
5 14 47
6 6 27
6 4 35
6 7 52
6 29 30
6 23 51