41 64
0 0 0 0 0 0 0 0 0 0 0 0 0 0 0 0 0 0 0 0 0 0 0 0 0 0 0 0 0 0 0 0 0 0 0 0 0 0 0 0 0 0 0 0 0 0 0 0 0 0 0 0 0 0 0 0 0 0 0 0 0 0 0 0
0 0 0 0 0 0 0 0 0 0 0 0 0 0 0 0 0 0 0 0 0 0 0 0 0 0 0 3 3 3 3 3 3 0 0 0 0 0 0 0 0 0 0 0 0 0 0 0 0 0 0 0 0 0 0 0 0 0 3 3 3 3 0 0
0 0 0 0 0 0 0 0 0 0 0 0 0 0 0 0 0 0 0 0 0 0 0 0 0 3 3 3 3 3 3 3 3 3 3 0 0 0 0 0 0 0 0 0 0 0 0 0 0 3 3 3 3 0 0 0 3 3 3 3 3 3 0 0
0 0 0 0 0 0 0 0 0 0 0 0 0 0 0 0 0 0 0 0 0 3 3 3 3 3 3 3 3 3 3 3 3 3 3 3 3 3 3 0 0 0 0 0 0 0 3 3 3 3 3 3 3 3 3 3 3 3 3 3 3 3 3 0
0 0 0 0 0 0 0 0 0 0 0 0 0 0 0 3 3 3 3 3 3 3 3 3 3 3 3 3 1 1 1 1 3 3 3 3 3 3 3 3 3 3 3 3 3 3 3 3 3 3 3 3 3 3 3 3 3 3 3 3 3 3 3 0
0 0 0 0 0 0 0 0 0 0 0 3 3 3 3 3 3 3 3 3 3 3 3 1 1 1 1 1 1 5 5 1 1 1 1 1 1 3 3 3 3 3 3 3 3 3 3 3 3 1 1 1 1 1 3 3 3 3 3 3 3 3 3 0
0 0 0 0 0 0 0 0 0 3 3 3 3 3 3 3 3 3 3 6 6 6 6 6 1 1 1 5 5 5 5 5 5 1 1 1 1 3 3 3 3 3 6 6 3 3 3 3 3 3 1 1 1 1 1 3 3 3 3 3 3 3 3 0
0 0 0 0 0 0 0 0 0 3 3 3 3 3 6 6 6 6 6 6 6 6 6 6 1 1 5 5 5 5 5 5 5 5 1 1 1 1 1 3 3 6 6 6 6 3 3 3 3 3 1 1 6 6 1 1 1 3 3 3 3 3 0 0
0 0 0 0 0 0 0 0 0 3 3 3 3 6 6 6 6 6 6 6 6 6 6 6 1 1 5 5 5 5 5 5 5 5 1 1 6 6 6 6 6 6 6 6 6 3 3 3 3 3 3 1 6 6 6 1 1 3 3 3 3 3 0 0
0 0 0 0 0 0 0 0 3 3 3 3 6 6 6 6 6 6 6 6 6 6 6 6 1 1 5 5 5 5 5 5 5 1 1 1 6 6 6 6 6 6 6 6 6 6 6 3 3 3 3 1 6 6 6 1 3 3 3 0 0 0 0 0
0 0 0 0 0 0 0 0 3 3 3 3 6 6 6 6 6 6 6 6 6 6 6 6 1 1 5 5 5 5 5 5 1 1 1 6 6 6 6 6 6 6 6 6 6 6 6 3 3 3 1 1 6 6 6 1 3 3 3 0 0 0 0 0
0 0 0 0 0 0 0 0 3 3 3 6 6 6 6 6 6 3 3 6 6 6 6 6 1 1 1 5 5 5 5 1 1 1 1 6 6 6 6 6 6 6 6 6 6 6 6 1 1 1 1 6 6 6 6 1 3 3 0 0 0 0 0 0
0 0 0 0 0 0 0 0 3 3 3 6 6 6 6 6 6 3 3 6 6 6 6 6 6 1 1 1 1 1 1 1 1 6 6 6 6 6 6 6 6 6 1 1 4 1 1 1 1 1 6 6 6 6 1 3 3 3 0 0 0 0 0 0
0 0 0 0 0 0 0 0 3 3 3 6 6 6 6 6 6 6 6 6 6 6 6 6 6 6 1 1 1 1 1 1 6 6 6 6 6 6 6 6 6 6 1 5 5 5 1 1 1 1 6 6 6 1 3 3 3 3 0 0 0 0 0 0
0 0 0 0 0 0 0 3 3 3 6 6 6 6 6 6 6 6 6 6 6 6 6 6 6 6 6 6 6 6 6 6 6 6 6 6 6 6 6 6 6 6 1 5 5 5 5 1 1 6 6 6 6 1 3 3 3 3 3 0 0 0 0 0
0 0 0 0 0 0 3 3 3 3 6 6 6 6 6 6 6 6 6 6 6 6 6 6 6 6 6 6 6 6 6 6 6 6 6 6 6 6 6 6 6 6 1 5 5 5 5 1 1 6 6 6 6 1 1 1 3 3 3 0 0 0 0 0
0 0 0 0 0 3 3 3 3 3 6 6 6 6 6 6 6 1 1 6 6 6 6 6 6 6 6 6 6 6 6 6 6 6 6 6 6 6 6 6 6 6 1 1 5 5 5 5 1 1 1 2 1 1 1 1 1 3 3 0 0 0 0 0
0 0 0 0 0 3 3 3 1 1 1 6 6 6 6 6 1 1 1 1 1 1 6 6 6 6 6 6 6 6 3 3 3 3 6 6 6 6 6 6 6 6 6 1 1 5 5 5 5 5 5 5 5 5 5 5 1 3 3 0 0 0 0 0
0 0 0 0 3 3 3 1 1 1 1 1 1 1 2 1 1 1 5 5 5 1 1 1 6 6 6 6 6 6 3 3 3 3 3 6 6 6 6 6 6 6 6 1 1 5 5 5 5 5 5 5 5 5 5 5 1 3 3 0 0 0 0 0
0 0 0 3 3 3 3 1 1 1 1 5 5 5 5 5 5 5 5 5 5 5 1 1 1 6 6 6 6 6 6 3 3 3 3 6 6 6 6 6 6 6 1 1 1 5 5 5 5 5 5 5 5 5 5 5 1 3 3 0 0 0 0 0
0 0 0 3 3 3 3 1 1 1 5 5 5 5 5 5 5 5 5 5 5 5 5 5 1 6 6 6 6 6 6 6 3 3 6 6 6 6 6 6 6 1 1 1 5 5 5 5 5 5 5 5 5 5 1 1 1 3 3 0 0 0 0 0
0 0 0 3 3 3 1 1 1 1 5 5 5 5 5 5 5 5 5 5 5 5 5 5 1 1 6 6 6 6 6 6 6 6 6 6 6 6 6 1 1 1 5 5 5 5 5 5 5 5 5 5 5 5 1 6 6 3 3 0 0 0 0 0
0 0 0 3 3 3 1 1 1 1 5 5 5 5 5 5 1 1 1 1 5 5 5 5 5 1 1 1 1 6 6 6 6 6 6 6 6 1 1 1 5 5 5 5 5 5 5 5 5 5 1 1 1 1 1 6 6 3 3 0 0 0 0 0
0 0 0 3 3 3 1 1 1 5 5 5 5 5 5 1 1 1 1 1 1 5 5 5 5 5 5 1 1 1 6 6 6 6 1 1 1 1 5 5 5 5 5 5 5 5 5 5 5 5 1 6 6 6 6 6 6 3 3 0 0 0 0 0
0 0 0 3 3 1 1 1 1 5 5 5 5 5 1 1 1 1 1 1 1 1 5 5 5 5 5 5 5 1 1 1 1 1 1 5 5 5 5 5 5 5 5 5 5 5 5 5 5 1 1 6 6 6 6 6 6 3 3 0 0 0 0 0
0 0 0 3 3 1 1 1 5 5 5 5 5 5 1 1 1 1 1 1 1 1 1 5 5 5 5 5 5 5 5 1 1 5 5 5 5 5 5 5 5 5 5 5 5 5 5 5 5 1 6 6 6 6 6 6 3 3 3 0 0 0 0 0
0 0 0 3 3 1 1 1 5 5 5 5 5 1 1 1 1 1 1 1 1 1 1 1 1 5 5 5 5 5 5 5 5 5 5 5 5 5 5 5 5 5 5 5 5 5 5 5 5 1 6 6 6 6 6 3 3 3 3 0 0 0 0 0
0 0 3 3 3 1 1 5 5 5 5 5 1 1 6 6 1 3 3 3 1 6 6 6 1 1 1 5 5 5 5 5 5 5 5 5 5 5 5 5 5 5 5 5 5 1 1 1 1 1 6 6 6 6 6 3 3 3 3 0 0 0 0 0
0 0 3 3 3 1 1 5 5 5 5 5 1 6 6 6 6 3 3 3 6 6 6 6 6 6 1 1 1 5 5 5 5 5 5 5 5 5 5 5 5 5 5 5 5 1 6 6 6 6 6 6 6 6 3 3 3 3 3 0 0 0 0 0
0 3 3 3 1 1 5 5 5 5 5 5 1 6 6 6 6 3 3 6 6 6 6 6 6 6 6 6 1 1 1 1 1 1 1 1 2 1 1 1 5 5 5 5 1 1 6 6 6 6 6 6 6 3 3 3 3 0 0 0 0 0 0 0
0 3 3 1 1 5 5 5 5 5 5 1 1 6 6 6 6 6 6 6 6 6 6 6 6 6 6 6 6 6 6 6 6 6 6 6 6 6 6 1 1 5 5 5 1 6 6 6 6 6 6 6 3 3 3 3 3 0 0 0 0 0 0 0
0 3 3 1 5 5 5 5 5 5 5 1 6 6 6 6 6 6 6 6 6 6 6 6 6 6 6 6 6 6 6 6 6 6 6 6 6 6 6 6 1 5 5 5 1 6 6 6 6 6 6 6 3 3 3 3 0 0 0 0 0 0 0 0
0 3 3 1 5 5 5 5 5 5 5 1 1 1 1 6 6 6 6 6 6 6 6 6 6 6 6 6 6 3 3 3 3 3 3 3 3 6 6 6 1 5 5 5 1 6 6 6 6 6 6 6 6 3 3 0 0 0 0 0 0 0 0 0
0 3 3 1 1 5 5 5 5 5 5 5 5 5 1 6 6 6 6 6 6 6 6 6 3 3 3 3 3 3 3 3 3 3 3 3 3 3 6 6 1 1 5 5 1 6 6 6 6 6 6 6 6 3 3 0 0 0 0 0 0 0 0 0
0 3 3 1 1 1 1 5 5 5 5 5 5 5 1 6 6 6 6 6 6 6 3 3 3 3 3 3 3 3 3 3 3 3 3 3 3 3 6 6 6 1 1 1 1 6 6 6 6 3 3 3 3 3 3 0 0 0 0 0 0 0 0 0
0 3 3 3 3 3 1 1 1 5 5 5 5 5 1 6 6 6 6 6 3 3 3 3 3 3 3 3 3 3 3 3 3 3 0 3 3 3 6 6 6 6 6 6 6 6 6 6 3 3 3 3 3 3 3 0 0 0 0 0 0 0 0 0
0 0 3 3 3 3 3 3 1 1 1 1 1 1 1 6 6 3 3 3 3 3 3 3 3 3 3 3 3 3 0 0 0 0 0 0 3 3 3 6 6 6 6 6 6 6 6 3 3 3 3 3 0 0 0 0 0 0 0 0 0 0 0 0
0 0 0 0 0 3 3 3 3 3 3 3 3 3 3 3 3 3 3 3 3 3 3 3 3 0 0 0 0 0 0 0 0 0 0 0 0 3 3 3 6 6 6 6 6 6 3 3 3 3 3 0 0 0 0 0 0 0 0 0 0 0 0 0
0 0 0 0 0 3 3 3 3 3 3 3 3 3 3 3 3 3 3 3 3 3 3 0 0 0 0 0 0 0 0 0 0 0 0 0 0 0 3 3 3 3 3 3 3 3 3 3 3 3 0 0 0 0 0 0 0 0 0 0 0 0 0 0
0 0 0 0 0 0 0 0 0 0 0 0 0 0 0 0 0 0 0 0 0 0 0 0 0 0 0 0 0 0 0 0 0 0 0 0 0 0 3 3 3 3 3 3 3 3 3 3 0 0 0 0 0 0 0 0 0 0 0 0 0 0 0 0
0 0 0 0 0 0 0 0 0 0 0 0 0 0 0 0 0 0 0 0 0 0 0 0 0 0 0 0 0 0 0 0 0 0 0 0 0 0 0 0 0 0 0 0 0 0 0 0 0 0 0 0 0 0 0 0 0 0 0 0 0 0 0 0
3
0 5 51 1 25 17 1 25 52
0