58 52
0 0 0 0 0 0 0 0 0 0 0 0 0 0 0 0 0 0 0 0 0 0 0 0 0 0 0 0 0 0 0 0 0 0 0 0 0 0 0 0 0 0 0 0 0 0 0 0 0 0 0 0
0 0 0 0 0 0 0 0 0 0 0 0 0 3 3 3 3 3 3 3 3 0 0 0 0 0 0 0 0 0 0 0 0 0 0 0 0 0 0 0 0 0 0 0 0 0 0 0 0 0 0 0
0 0 0 0 0 0 0 0 0 0 0 3 3 3 3 3 3 3 3 3 3 0 0 0 0 0 0 0 0 0 0 0 0 0 0 0 0 0 0 0 0 0 0 0 0 0 0 0 0 0 0 0
0 0 0 0 0 0 0 0 0 0 0 3 3 3 3 1 1 1 1 3 3 0 0 0 0 0 0 0 0 0 0 0 0 0 0 0 0 0 0 0 0 0 0 0 0 0 0 0 0 0 0 0
0 0 0 0 0 0 0 0 0 0 3 3 3 1 1 1 5 5 1 3 3 3 0 0 0 0 0 0 0 0 0 0 0 0 0 0 0 0 0 0 0 0 0 0 0 0 0 0 0 0 0 0
0 0 0 0 0 0 0 0 0 0 3 3 3 1 1 5 5 5 1 3 3 3 3 0 0 0 0 0 0 0 0 0 0 0 0 0 0 0 0 0 0 0 0 0 0 0 0 0 0 0 0 0
0 0 0 0 0 0 0 0 0 0 3 3 1 1 5 5 5 5 1 1 3 3 3 3 0 0 0 0 0 3 3 3 3 3 3 3 3 3 3 0 0 0 0 0 0 0 0 0 0 0 0 0
0 0 0 0 0 0 0 0 0 0 3 3 1 1 5 5 5 5 1 1 1 3 3 3 0 0 0 0 3 3 3 3 3 3 3 3 3 3 3 0 0 0 0 0 0 0 0 0 0 0 0 0
0 0 0 0 0 0 0 0 0 0 3 3 1 1 5 5 5 5 5 1 1 1 3 3 0 0 0 0 3 3 3 1 1 1 1 1 1 3 3 3 0 0 0 0 0 0 0 0 0 0 0 0
0 0 0 0 0 0 0 0 0 3 3 3 1 1 5 5 5 5 5 1 1 1 3 3 3 0 0 3 3 3 1 1 1 5 5 5 1 1 3 3 3 0 0 0 0 0 0 0 0 0 0 0
0 0 0 0 0 0 0 0 0 3 3 3 1 5 5 5 5 5 5 5 1 1 3 3 3 3 3 3 3 3 1 1 5 5 5 5 1 1 1 3 3 0 0 0 0 0 0 0 0 0 0 0
0 0 0 0 0 0 0 0 3 3 3 1 1 5 5 5 5 5 5 5 1 1 1 3 3 3 3 3 3 1 1 5 5 5 5 5 1 1 1 3 3 3 0 0 0 0 0 0 0 0 0 0
0 0 0 0 0 0 0 0 3 3 3 1 1 5 5 5 5 5 5 5 1 1 1 1 1 1 1 1 1 1 1 5 5 5 5 5 1 1 1 3 3 3 3 3 0 0 0 0 0 0 0 0
0 0 0 0 0 0 0 0 3 3 1 1 1 5 5 5 5 5 5 5 1 1 1 1 1 1 1 1 1 1 5 5 5 5 5 5 1 1 1 3 3 3 3 3 3 3 3 3 3 0 0 0
0 0 0 0 0 0 0 0 3 3 1 1 5 5 5 5 5 5 5 1 1 1 1 1 1 1 1 1 1 1 5 5 5 5 5 5 1 1 3 3 3 3 3 3 3 3 3 3 3 0 0 0
0 0 0 0 0 0 0 3 3 3 1 1 5 5 5 5 5 5 1 1 1 1 1 1 1 1 1 1 1 5 5 5 5 5 5 5 1 1 3 3 3 3 3 1 1 1 1 3 3 0 0 0
0 0 0 0 0 3 3 3 3 3 1 1 5 5 5 5 5 5 1 1 1 1 1 1 1 1 1 1 5 5 5 5 5 5 5 1 1 1 1 3 3 3 1 1 5 5 1 3 3 0 0 0
0 0 0 0 0 3 3 3 3 1 1 1 5 5 5 5 5 5 1 1 1 1 1 1 1 1 1 1 5 5 5 5 5 5 1 1 1 1 1 1 1 1 1 5 5 5 1 3 3 0 0 0
0 0 0 0 0 3 3 1 1 1 1 1 5 5 5 5 5 5 5 5 5 5 1 1 1 1 1 1 5 5 5 5 5 5 1 1 1 1 1 1 1 1 5 5 5 5 1 3 3 0 0 0
0 0 0 0 0 3 3 1 1 1 5 5 5 5 5 5 5 5 5 5 5 5 5 1 1 1 1 1 5 5 5 5 5 5 1 1 1 1 1 1 1 5 5 5 5 5 1 3 3 3 0 0
0 0 0 0 0 3 3 1 1 5 5 5 5 5 5 5 5 5 5 5 5 5 1 1 1 1 1 1 5 5 5 5 5 5 1 1 1 1 1 1 1 5 5 5 5 1 1 3 3 3 3 0
0 0 0 0 0 3 3 1 1 5 5 5 5 5 5 5 5 5 5 5 5 5 1 1 1 1 1 1 5 5 5 5 5 1 1 1 1 1 1 1 1 5 5 5 5 1 1 1 3 3 3 0
0 0 0 0 0 3 3 1 1 1 5 5 5 5 5 5 5 5 5 5 5 1 1 1 1 1 1 1 1 5 5 5 5 1 1 1 1 1 1 1 1 1 5 5 5 5 5 1 1 3 3 0
0 0 0 0 3 3 3 1 1 1 1 5 5 5 5 5 5 5 5 5 5 1 1 1 1 1 1 1 1 5 5 5 5 1 1 1 1 1 1 1 1 1 1 5 5 5 5 5 1 3 3 0
0 0 0 3 3 3 3 1 1 1 1 1 5 5 5 5 5 5 5 5 1 1 1 1 1 1 1 1 1 5 5 5 5 1 1 1 1 1 1 1 1 1 1 5 5 5 5 5 1 3 3 0
0 0 3 3 3 3 1 1 1 1 1 1 1 5 5 5 5 5 5 5 1 1 1 6 6 6 6 1 1 1 5 5 5 1 1 1 1 1 1 1 1 1 1 1 1 5 5 5 1 3 3 0
0 3 3 3 3 1 1 1 1 1 1 1 1 1 5 5 5 5 5 1 1 1 6 6 6 6 6 6 1 1 5 5 5 1 1 1 1 1 1 1 1 1 3 3 1 1 1 1 1 3 3 0
0 3 3 3 1 1 1 1 3 3 1 1 1 1 1 5 5 5 1 1 1 6 6 6 6 6 6 6 6 1 5 5 5 1 1 1 1 1 1 1 1 3 3 3 3 3 3 3 3 3 3 0
0 3 3 1 1 1 1 3 3 3 3 1 1 1 1 1 2 1 1 1 1 6 6 6 6 6 6 6 6 1 5 5 5 1 1 1 1 1 1 1 1 3 3 3 3 3 3 3 3 3 3 0
0 3 3 1 1 1 3 3 3 3 3 3 1 1 1 1 1 1 1 1 6 6 6 6 6 6 6 6 6 1 5 5 1 1 1 1 6 6 6 6 1 1 3 3 3 3 3 0 0 0 0 0
0 3 3 1 1 3 3 3 3 3 3 3 3 1 1 1 1 1 1 1 6 6 6 6 6 6 6 6 6 1 5 5 1 1 1 6 6 6 6 6 1 1 1 1 3 3 3 3 0 0 0 0
0 3 3 1 1 3 3 3 0 0 3 3 3 3 1 1 1 1 1 1 6 6 6 6 6 6 6 6 6 1 5 5 1 1 1 6 6 6 6 1 1 5 5 1 1 3 3 3 0 0 0 0
0 3 3 1 1 3 3 0 0 0 0 3 3 3 1 1 1 1 1 1 1 6 6 6 6 6 6 6 1 1 5 5 1 1 1 6 6 6 6 1 1 5 5 5 1 1 3 3 3 0 0 0
0 3 3 1 1 3 3 0 0 0 0 0 3 3 1 1 1 1 2 1 1 1 6 6 6 6 6 6 1 1 5 5 1 1 1 1 6 6 6 1 2 5 5 5 5 1 3 3 3 0 0 0
0 3 3 1 1 3 3 0 0 0 0 0 3 3 1 1 5 5 5 5 5 1 1 6 6 6 1 1 1 1 5 5 5 1 1 1 6 6 6 1 1 5 5 5 5 1 1 3 3 0 0 0
0 3 3 1 1 3 3 0 0 0 0 0 3 3 1 5 5 5 5 5 5 5 1 1 1 1 1 1 1 5 5 5 5 1 1 1 1 1 1 1 1 5 5 5 5 5 1 3 3 0 0 0
0 3 3 1 1 3 3 0 0 0 0 0 3 3 1 5 5 5 5 5 5 5 1 1 1 1 1 1 1 5 5 5 5 5 1 1 1 1 1 1 5 5 5 5 5 5 1 3 3 0 0 0
0 3 3 1 1 3 3 0 0 0 0 0 3 3 1 5 5 5 5 5 5 5 5 1 1 1 1 1 1 5 5 5 5 5 5 1 1 1 1 5 5 5 5 5 5 5 1 3 3 0 0 0
0 3 3 1 1 3 3 0 0 0 0 0 3 3 1 1 5 5 5 5 5 5 5 1 1 4 1 1 5 5 5 5 5 5 5 5 5 5 5 5 5 5 5 5 5 5 1 3 3 0 0 0
0 3 3 1 1 3 3 0 0 0 0 0 3 3 3 1 5 5 5 5 5 5 5 5 5 5 5 5 5 5 5 5 5 5 5 5 5 5 5 5 5 5 5 5 5 1 1 3 3 0 0 0
0 3 3 1 1 3 3 0 0 0 0 0 3 3 3 1 1 5 5 5 5 5 5 5 5 5 5 5 5 5 5 5 5 5 5 5 5 5 5 5 5 5 5 5 5 1 3 3 3 0 0 0
0 3 3 1 1 3 3 0 0 0 0 0 0 3 3 3 1 1 5 5 5 5 5 5 5 5 5 5 5 5 5 5 5 5 5 5 5 5 5 5 5 5 5 5 5 1 3 3 3 0 0 0
0 3 3 1 1 3 3 0 0 0 0 0 0 3 3 3 3 1 1 1 1 5 5 5 5 5 5 5 5 5 5 5 5 5 5 5 5 5 5 5 5 5 5 5 1 1 3 3 0 0 0 0
0 3 3 1 1 3 3 0 0 0 0 0 0 0 3 3 3 3 3 3 1 1 5 5 5 5 5 5 5 5 5 5 5 5 5 5 5 5 5 5 5 5 5 5 1 1 3 3 3 3 0 0
0 3 3 1 1 3 3 3 0 0 0 0 0 0 0 3 3 3 3 3 1 1 5 5 5 5 5 5 5 5 5 5 5 5 5 5 5 5 5 1 1 5 5 5 1 1 3 3 3 3 3 0
0 3 3 1 1 3 3 3 3 3 0 0 0 0 0 0 0 0 3 3 1 1 1 1 5 5 5 5 5 5 5 5 5 5 5 5 5 5 1 1 1 5 5 5 5 1 1 1 3 3 3 0
0 3 3 1 1 1 3 3 3 3 3 0 0 0 0 0 0 0 3 3 3 1 1 1 1 5 5 5 5 5 5 5 5 5 5 5 5 1 1 1 1 5 5 5 5 5 5 1 1 3 3 0
0 3 3 1 1 1 1 1 3 3 3 0 0 0 0 0 0 0 3 3 3 3 1 1 1 1 5 5 5 5 5 5 5 5 5 5 1 1 3 3 1 1 5 5 5 5 5 5 1 3 3 0
0 3 3 1 1 1 1 1 1 3 3 3 0 0 0 0 0 0 0 3 3 3 3 3 1 1 1 1 1 5 5 5 5 5 5 1 1 3 3 3 3 1 1 5 5 5 5 5 1 3 3 0
0 3 3 1 1 1 1 1 1 3 3 3 3 0 0 0 0 0 0 0 3 3 3 3 3 3 1 1 1 1 1 1 1 1 1 1 1 3 3 3 3 3 1 1 1 5 5 1 1 3 3 0
0 3 3 1 1 1 1 1 1 1 3 3 3 0 0 0 0 0 0 0 0 0 3 3 3 3 3 3 3 3 3 3 3 3 3 3 3 3 3 3 3 3 3 3 1 1 1 1 3 3 3 0
0 3 3 3 1 1 1 1 1 1 1 3 3 0 0 0 0 0 0 0 0 0 0 0 3 3 3 3 3 3 3 3 3 3 3 3 3 3 3 0 3 3 3 3 3 3 3 3 3 3 3 0
0 3 3 3 1 1 1 1 1 1 1 3 3 0 0 0 0 0 0 0 0 0 0 0 0 0 0 0 0 0 0 0 0 0 0 0 0 0 0 0 0 0 3 3 3 3 3 3 3 3 0 0
0 0 3 3 3 1 1 1 1 1 3 3 3 0 0 0 0 0 0 0 0 0 0 0 0 0 0 0 0 0 0 0 0 0 0 0 0 0 0 0 0 0 0 0 0 0 0 0 0 0 0 0
0 0 3 3 3 3 1 1 1 3 3 3 3 0 0 0 0 0 0 0 0 0 0 0 0 0 0 0 0 0 0 0 0 0 0 0 0 0 0 0 0 0 0 0 0 0 0 0 0 0 0 0
0 0 0 3 3 3 3 3 3 3 3 3 0 0 0 0 0 0 0 0 0 0 0 0 0 0 0 0 0 0 0 0 0 0 0 0 0 0 0 0 0 0 0 0 0 0 0 0 0 0 0 0
0 0 0 0 3 3 3 3 3 3 3 0 0 0 0 0 0 0 0 0 0 0 0 0 0 0 0 0 0 0 0 0 0 0 0 0 0 0 0 0 0 0 0 0 0 0 0 0 0 0 0 0
0 0 0 0 0 0 0 0 0 0 0 0 0 0 0 0 0 0 0 0 0 0 0 0 0 0 0 0 0 0 0 0 0 0 0 0 0 0 0 0 0 0 0 0 0 0 0 0 0 0 0 0
3
2
0 10 33
1 15 24
9
3 46 6
5 6 20
5 28 41
5 22 34
5 38 28
5 47 47
5 21 11
6 5 16
6 10 37
2
0 14 37
1 22 19
15
3 46 6
5 47 47
5 13 32
5 18 28
5 23 32
5 35 29
5 13 32
5 18 28
5 23 32
5 35 29
5 32 14
5 32 28
5 47 34
5 33 34
6 15 20
2
0 4 16
1 47 43
6
3 46 6
5 19 33
5 16 28
6 28 24
6 34 30
6 31 36