58 52
0 0 0 0 0 0 0 0 0 0 0 0 0 0 0 0 0 0 0 0 0 0 0 0 0 0 0 0 0 0 0 0 0 0 0 0 0 0 0 0 0 0 0 0 0 0 0 0 0 0 0 0
0 0 0 0 0 0 0 0 0 0 0 0 0 3 3 3 3 3 3 3 3 0 0 0 0 0 0 0 0 0 0 0 0 0 0 0 0 0 0 0 0 0 0 0 0 0 0 0 0 0 0 0
0 0 0 0 0 0 0 0 0 0 0 3 3 3 3 3 3 3 3 3 3 0 0 0 0 0 0 0 0 0 0 0 0 0 0 0 0 0 0 0 0 0 0 0 0 0 0 0 0 0 0 0
0 0 0 0 0 0 0 0 0 0 0 3 3 3 3 1 1 1 1 3 3 0 0 0 0 0 0 0 0 0 0 0 0 0 0 0 0 0 0 0 0 0 0 0 0 0 0 0 0 0 0 0
0 0 0 0 0 0 0 0 0 0 3 3 3 1 1 1 5 5 1 3 3 3 0 0 0 0 0 0 0 0 0 0 0 0 0 0 0 0 0 0 0 0 0 0 0 0 0 0 0 0 0 0
0 0 0 0 0 0 0 0 0 0 3 3 3 1 1 5 5 5 1 3 3 3 3 0 0 0 0 0 0 0 0 0 0 0 0 0 0 0 0 0 0 0 0 0 0 0 0 0 0 0 0 0
0 0 0 0 0 0 0 0 0 0 3 3 1 1 5 5 5 5 1 1 3 3 3 3 0 0 0 0 0 3 3 3 3 3 3 3 3 3 3 0 0 0 0 0 0 0 0 0 0 0 0 0
0 0 0 0 0 0 0 0 0 0 3 3 1 1 5 5 5 5 1 1 1 3 3 3 0 0 0 0 3 3 3 3 3 3 3 3 3 3 3 0 0 0 0 0 0 0 0 0 0 0 0 0
0 0 0 0 0 0 0 0 0 0 3 3 1 1 5 5 5 5 5 1 1 1 3 3 0 0 0 0 3 3 3 1 1 1 1 1 1 3 3 3 0 0 0 0 0 0 0 0 0 0 0 0
0 0 0 0 0 0 0 0 0 3 3 3 1 1 5 5 5 5 5 1 1 1 3 3 3 0 0 3 3 3 1 1 1 5 5 5 1 1 3 3 3 0 0 0 0 0 0 0 0 0 0 0
0 0 0 0 0 0 0 0 0 3 3 3 1 5 5 5 5 5 5 5 1 1 3 3 3 3 3 3 3 3 1 1 5 5 5 5 1 1 1 3 3 0 0 0 0 0 0 0 0 0 0 0
0 0 0 0 0 0 0 0 3 3 3 1 1 5 5 5 5 5 5 5 1 1 1 3 3 3 3 3 3 1 1 5 5 5 5 5 1 1 1 3 3 0 0 0 0 0 0 0 0 0 0 0
0 0 0 0 0 0 0 0 3 3 3 1 1 5 5 5 5 5 5 5 1 1 1 1 1 1 1 1 1 1 1 5 5 5 5 5 1 1 1 3 3 0 3 3 3 3 3 3 3 0 0 0
0 0 0 0 0 0 0 0 3 3 1 1 1 5 5 5 5 5 5 5 1 1 1 1 1 1 1 1 1 1 5 5 5 5 5 5 1 1 1 3 3 3 3 3 3 3 3 3 3 0 0 0
0 0 0 0 0 0 0 0 3 3 1 1 5 5 5 5 5 5 5 1 1 1 1 1 1 1 1 1 1 1 5 5 5 5 5 5 1 1 3 3 3 3 3 3 1 1 1 3 3 0 0 0
0 0 0 0 0 0 0 3 3 3 1 1 5 5 5 5 5 5 1 1 1 1 1 1 1 1 1 1 1 5 5 5 5 5 5 5 1 1 3 3 3 3 3 1 1 5 1 3 3 0 0 0
0 0 0 0 0 3 3 3 3 3 1 1 5 5 5 5 5 5 1 1 1 1 1 1 1 1 1 1 5 5 5 5 5 5 5 1 1 1 1 3 3 3 1 1 5 5 1 3 3 0 0 0
0 0 0 0 0 3 3 3 3 1 1 1 5 5 5 5 5 5 1 1 1 1 1 1 1 1 1 1 5 5 5 5 5 5 1 1 1 1 1 1 1 1 1 5 5 5 1 3 3 0 0 0
0 0 0 0 0 3 3 1 1 1 1 1 5 5 5 5 5 5 5 5 5 5 1 1 1 1 1 1 5 5 5 5 5 5 1 1 1 1 1 1 1 1 5 5 5 5 1 3 3 0 0 0
0 0 0 0 0 3 3 1 1 1 5 5 5 5 5 5 5 5 5 5 5 5 5 1 1 1 1 1 5 5 5 5 5 5 1 1 1 1 1 1 1 5 5 5 5 5 1 3 3 3 0 0
0 0 0 0 0 3 3 1 1 5 5 5 5 5 5 5 5 5 5 5 5 5 1 1 1 1 1 1 5 5 5 5 5 5 1 1 1 1 1 1 1 5 5 5 5 1 1 3 3 3 3 0
0 0 0 0 0 3 3 1 1 5 5 5 5 5 5 5 5 5 5 5 5 5 1 1 1 1 1 1 5 5 5 5 5 1 1 1 1 1 1 1 1 5 5 5 5 1 1 1 3 3 3 0
0 0 0 0 0 3 3 1 1 1 5 5 5 5 5 5 5 5 5 5 5 1 1 1 1 1 1 1 1 5 5 5 5 1 1 1 1 1 1 1 1 1 5 5 5 5 5 1 1 3 3 0
0 0 0 3 3 3 3 3 1 1 1 5 5 5 5 5 5 5 5 5 5 1 1 1 1 1 1 1 1 5 5 5 5 1 1 1 1 1 1 1 1 1 1 5 5 5 5 5 1 3 3 0
0 0 3 3 3 3 3 3 1 1 1 1 5 5 5 5 5 5 5 5 1 1 1 1 1 1 1 1 1 5 5 5 5 1 1 1 1 1 1 1 1 1 1 5 5 5 5 5 1 3 3 0
0 3 3 3 3 1 1 1 1 1 1 1 1 5 5 5 5 5 5 5 1 1 1 6 6 6 6 1 1 1 5 5 5 1 1 1 1 1 1 1 1 1 1 1 1 5 5 5 1 3 3 0
0 3 3 3 1 1 1 1 1 1 1 1 1 1 5 5 5 5 5 1 1 1 6 6 6 6 6 6 1 1 5 5 5 1 1 1 1 1 1 1 1 1 3 3 1 1 1 1 1 3 3 0
0 3 3 3 1 1 1 1 1 1 1 1 1 1 1 5 5 5 1 1 1 6 6 6 6 6 6 6 6 1 5 5 5 1 1 1 1 1 1 1 1 3 3 3 3 3 3 3 3 3 3 0
0 3 3 1 1 1 1 1 3 3 1 1 1 1 1 1 2 1 1 1 1 6 6 6 6 6 6 6 6 1 5 5 5 1 1 1 1 1 1 1 1 3 3 3 3 3 3 3 3 3 3 0
0 3 3 1 1 1 1 3 3 3 3 1 1 1 1 1 1 1 1 1 6 6 6 6 6 6 6 6 6 1 5 5 1 1 1 1 6 6 6 6 1 1 3 3 3 3 3 0 0 0 0 0
0 3 3 1 1 1 3 3 3 3 3 3 1 1 1 1 1 1 1 1 6 6 6 6 6 6 6 6 6 1 5 5 1 1 1 6 6 6 6 6 1 1 1 1 3 3 3 3 0 0 0 0
0 3 3 1 1 3 3 3 3 3 3 3 3 1 1 1 1 1 1 1 6 6 6 6 6 6 6 6 6 1 5 5 1 1 1 6 6 6 6 1 1 5 5 1 1 3 3 3 0 0 0 0
0 3 3 1 1 3 3 3 0 0 3 3 3 3 3 1 1 1 1 1 1 6 6 6 6 6 6 6 1 1 5 5 5 1 1 6 6 6 6 1 1 5 5 5 1 1 3 3 3 0 0 0
0 3 3 1 1 3 3 0 0 0 0 3 3 3 3 1 1 1 2 1 1 1 6 6 6 6 6 6 1 1 5 5 5 1 1 1 6 6 6 1 2 5 5 5 5 1 3 3 3 0 0 0
0 3 3 1 1 3 3 0 0 0 0 0 3 3 1 1 5 5 5 5 5 1 1 6 6 6 1 1 1 5 5 5 5 5 1 1 6 6 6 1 1 5 5 5 5 1 1 3 3 0 0 0
0 3 3 1 1 3 3 0 0 0 0 0 3 3 1 5 5 5 5 5 5 5 1 1 1 1 1 1 1 5 5 5 5 5 1 1 1 1 1 1 1 5 5 5 5 5 1 3 3 0 0 0
0 3 3 1 1 3 3 0 0 0 0 0 3 3 1 5 5 5 5 5 5 5 1 1 1 1 1 1 1 5 5 5 5 5 5 1 1 1 1 1 5 5 5 5 5 5 1 3 3 0 0 0
0 3 3 1 1 3 3 0 0 0 0 0 3 3 1 5 5 5 5 5 5 5 5 1 1 1 1 1 1 5 5 5 5 5 5 5 1 1 1 5 5 5 5 5 5 5 1 3 3 0 0 0
0 3 3 1 1 3 3 0 0 0 0 0 3 3 1 1 5 5 5 5 5 5 5 1 1 1 1 1 1 5 5 5 5 5 5 5 5 5 5 5 5 5 5 5 5 5 1 3 3 0 0 0
0 3 3 1 1 3 3 0 0 0 0 0 3 3 3 1 5 5 5 5 5 5 5 5 1 1 1 1 1 5 5 5 5 5 5 5 5 5 5 5 5 5 5 5 5 1 1 3 3 0 0 0
0 3 3 1 1 3 3 0 0 0 0 0 3 3 3 1 1 5 5 5 5 5 5 5 1 1 1 1 5 5 5 5 5 5 5 5 5 5 5 5 5 5 5 5 5 1 3 3 3 0 0 0
0 3 3 1 1 3 3 0 0 0 0 0 0 3 3 3 1 1 5 5 5 5 5 5 5 1 1 1 5 5 5 5 5 5 5 5 5 5 5 5 5 5 5 5 5 1 3 3 3 0 0 0
0 3 3 1 1 3 3 0 0 0 0 0 0 3 3 3 3 1 1 1 1 5 5 5 5 5 5 5 5 5 5 5 5 5 5 5 5 5 5 5 5 5 5 5 1 1 3 3 0 0 0 0
0 3 3 1 1 3 3 0 0 0 0 0 0 0 3 3 3 3 3 3 1 1 5 5 5 5 5 5 5 5 5 5 5 5 5 5 5 5 5 5 5 5 5 5 1 1 3 3 3 3 0 0
0 3 3 1 1 3 3 3 0 0 0 0 0 0 0 3 3 3 3 3 1 1 5 5 5 5 5 5 5 5 5 5 5 5 5 5 5 5 5 1 1 5 5 5 1 1 3 3 3 3 3 0
0 3 3 1 1 3 3 3 3 3 0 0 0 0 0 0 0 0 3 3 3 1 5 5 5 5 5 5 5 5 5 5 5 5 5 5 5 5 1 1 1 5 5 5 5 1 1 1 3 3 3 0
0 3 3 1 1 1 3 3 3 3 3 0 0 0 0 0 0 0 3 3 3 1 1 5 5 5 5 5 5 5 5 5 5 5 5 5 5 1 1 1 1 5 5 5 5 5 5 1 1 3 3 0
0 3 3 1 1 1 1 1 3 3 3 0 0 0 0 0 0 0 0 3 3 3 1 1 5 5 5 5 5 5 5 5 5 5 5 5 1 1 3 3 1 1 5 5 5 5 5 5 1 3 3 0
0 3 3 1 1 1 1 1 1 3 3 3 0 0 0 0 0 0 0 3 3 3 3 1 1 1 5 5 5 5 5 5 5 5 5 5 1 3 3 3 3 1 1 5 5 5 5 5 1 3 3 0
0 3 3 1 1 1 1 1 1 3 3 3 3 0 0 0 0 0 0 3 3 3 3 3 3 1 1 1 5 5 5 5 5 5 1 1 1 3 3 3 3 3 1 1 1 5 5 1 1 3 3 0
0 3 3 1 1 1 1 1 1 1 3 3 3 0 0 0 0 0 0 0 0 3 3 3 3 3 3 1 1 1 1 1 1 1 1 3 3 3 3 3 3 3 3 3 1 1 1 1 3 3 3 0
0 3 3 3 1 1 1 1 1 1 1 3 3 0 0 0 0 0 0 0 0 0 0 3 3 3 3 3 3 3 3 3 3 3 3 3 3 3 3 0 3 3 3 3 3 3 3 3 3 3 3 0
0 3 3 3 1 1 1 1 1 1 1 3 3 0 0 0 0 0 0 0 0 0 0 0 0 3 3 3 3 3 3 3 3 3 3 3 3 0 0 0 0 0 3 3 3 3 3 3 3 3 0 0
0 0 3 3 3 1 1 1 1 1 3 3 3 0 0 0 0 0 0 0 0 0 0 0 0 0 0 0 0 0 0 0 0 0 0 0 0 0 0 0 0 0 0 0 0 0 0 0 0 0 0 0
0 0 3 3 3 3 1 1 1 3 3 3 3 0 0 0 0 0 0 0 0 0 0 0 0 0 0 0 0 0 0 0 0 0 0 0 0 0 0 0 0 0 0 0 0 0 0 0 0 0 0 0
0 0 0 3 3 3 3 3 3 3 3 3 0 0 0 0 0 0 0 0 0 0 0 0 0 0 0 0 0 0 0 0 0 0 0 0 0 0 0 0 0 0 0 0 0 0 0 0 0 0 0 0
0 0 0 0 3 3 3 3 3 3 3 0 0 0 0 0 0 0 0 0 0 0 0 0 0 0 0 0 0 0 0 0 0 0 0 0 0 0 0 0 0 0 0 0 0 0 0 0 0 0 0 0
0 0 0 0 0 0 0 0 0 0 0 0 0 0 0 0 0 0 0 0 0 0 0 0 0 0 0 0 0 0 0 0 0 0 0 0 0 0 0 0 0 0 0 0 0 0 0 0 0 0 0 0
2
0 10 33 1 24 37
1
3 46 6