39 33
0 0 0 0 0 0 0 0 0 0 0 0 0 0 0 0 0 0 0 0 0 0 0 0 0 0 0 0 0 0 0 0 0
0 0 0 0 0 0 0 0 3 3 3 3 3 3 3 3 3 0 0 0 0 0 3 3 3 3 3 3 3 3 3 3 0
0 0 0 0 0 0 0 3 3 3 3 3 3 3 3 3 3 3 3 3 3 3 3 3 3 3 3 3 3 3 3 3 0
0 0 0 0 0 0 3 3 3 3 1 1 1 1 1 3 3 3 3 3 3 3 3 3 1 1 1 1 3 3 3 3 0
0 0 0 0 0 3 3 3 3 1 1 5 5 5 1 1 3 3 3 3 3 3 3 1 1 5 5 1 3 3 3 3 0
0 0 0 0 0 3 3 3 1 1 5 5 5 5 5 1 3 3 3 3 3 3 1 1 5 5 5 1 1 3 3 3 0
0 0 0 0 3 3 3 1 1 5 5 5 5 5 5 1 3 3 3 3 3 3 1 5 5 5 5 5 1 3 3 3 0
0 0 0 0 3 3 3 1 5 5 5 5 5 5 1 1 3 3 3 3 3 3 1 5 5 5 5 5 1 1 3 3 0
0 0 0 3 3 3 1 1 5 5 5 5 5 5 1 1 3 3 3 3 3 3 1 1 5 5 5 5 5 1 3 3 0
0 0 0 3 3 3 1 5 5 5 5 5 5 1 1 1 1 3 3 3 3 1 1 1 5 5 5 5 5 1 3 3 0
0 0 0 3 3 1 1 5 5 5 5 5 1 1 1 1 1 1 1 1 1 1 1 1 5 5 5 5 5 1 3 3 0
0 0 3 3 3 1 5 5 5 5 5 1 1 1 1 1 5 5 5 5 5 1 1 5 5 5 5 5 5 1 3 3 0
0 0 3 3 3 1 5 5 5 5 5 1 1 1 1 5 5 5 5 5 5 5 5 5 5 5 5 5 5 1 3 3 0
0 3 3 3 1 1 5 5 5 5 1 1 1 1 5 5 5 5 5 5 5 5 5 5 5 5 5 5 5 1 3 3 0
0 3 3 3 1 5 5 5 5 5 1 6 6 1 1 5 5 5 5 5 5 5 5 5 5 5 5 5 1 1 3 3 0
0 3 3 1 1 5 5 5 5 5 2 6 6 1 1 5 5 5 5 5 5 5 5 5 5 5 5 1 1 3 3 3 0
0 3 3 1 5 5 5 5 5 5 1 6 6 6 1 1 5 5 5 1 1 1 1 1 1 1 1 1 3 3 3 3 0
0 3 3 1 5 5 5 5 5 5 1 6 6 6 6 1 1 2 1 1 1 1 1 1 1 1 1 3 3 3 3 0 0
0 3 3 1 5 5 5 5 5 5 1 6 6 6 6 6 6 6 6 1 1 1 1 1 1 1 3 3 3 3 0 0 0
0 3 3 1 1 5 5 5 5 1 1 1 6 6 6 6 6 6 6 6 6 6 1 1 1 1 3 3 3 0 0 0 0
0 3 3 3 1 5 5 5 1 1 1 1 1 6 6 6 6 6 6 6 6 6 6 1 1 3 3 3 0 0 0 0 0
0 3 3 3 1 1 1 1 1 1 1 1 1 1 1 1 6 6 6 6 6 6 6 1 1 3 3 3 0 0 0 0 0
0 3 3 3 1 1 1 1 1 1 1 1 1 1 1 1 1 1 1 6 6 6 6 1 1 3 3 3 0 0 0 0 0
0 3 3 3 1 1 1 5 1 1 1 5 5 1 1 1 1 1 1 1 1 2 1 1 1 3 3 3 0 0 0 0 0
0 3 3 1 1 5 5 5 5 5 5 5 5 1 1 1 1 1 1 1 5 5 5 1 1 1 3 3 3 0 0 0 0
0 3 3 1 5 5 5 5 5 5 5 5 5 1 1 1 1 1 1 5 5 5 5 5 1 1 3 3 3 3 0 0 0
0 3 3 1 1 5 5 5 5 5 5 5 5 5 1 1 1 1 5 5 5 5 5 5 5 1 1 3 3 3 3 0 0
0 3 3 3 1 1 5 5 5 5 5 5 5 5 1 1 1 5 5 5 5 5 5 5 5 5 1 1 3 3 3 3 0
0 3 3 3 3 1 1 5 5 5 5 5 5 5 5 1 1 5 5 5 5 5 5 5 5 5 5 1 1 3 3 3 0
0 0 3 3 3 3 1 1 5 5 5 5 5 5 5 5 5 5 5 5 5 5 5 5 5 5 5 5 1 1 3 3 0
0 0 0 3 3 3 3 1 1 5 5 5 5 5 5 5 5 5 5 5 5 5 5 5 5 5 5 5 5 1 3 3 0
0 0 0 0 3 3 3 3 1 1 5 5 5 5 5 5 5 5 5 5 5 5 5 5 5 5 5 5 5 1 3 3 0
0 0 0 0 0 3 3 3 3 1 1 5 5 5 5 5 5 5 1 1 1 5 5 5 5 5 5 5 5 1 3 3 0
0 0 0 0 0 0 3 3 3 3 1 1 5 5 5 5 1 1 1 1 1 1 5 5 5 5 5 5 1 1 3 3 0
0 0 0 0 0 0 0 3 3 3 3 1 1 1 1 1 1 1 1 1 1 1 1 5 5 5 5 1 1 3 3 3 0
0 0 0 0 0 0 0 0 3 3 3 3 3 3 3 3 3 3 3 3 3 1 1 1 1 1 1 1 3 3 3 3 0
0 0 0 0 0 0 0 0 0 3 3 3 3 3 3 3 3 3 3 3 3 3 3 3 3 3 3 3 3 3 3 0 0
0 0 0 0 0 0 0 0 0 0 0 0 0 0 0 0 0 0 0 0 3 3 3 3 3 3 3 3 3 3 0 0 0
0 0 0 0 0 0 0 0 0 0 0 0 0 0 0 0 0 0 0 0 0 0 0 0 0 0 0 0 0 0 0 0 0
2
2
0 17 24
1 8 11
7
5 5 14
5 4 26
5 30 28
5 25 15
5 9 14
5 19 5
6 25 6
2
0 23 7
1 12 27
7
3 4 12
5 30 28
5 26 13
5 21 9
5 11 6
5 5 24
5 18 25