39 33
0 0 0 0 0 0 0 0 0 0 0 0 0 0 0 0 0 0 0 0 0 0 0 0 0 0 0 0 0 0 0 0 0
0 0 0 0 0 0 0 0 3 3 3 3 3 3 3 3 3 0 0 0 0 0 3 3 3 3 3 3 3 3 3 3 0
0 0 0 0 0 0 0 3 3 3 3 3 3 3 3 3 3 3 0 0 0 3 3 3 3 3 3 3 3 3 3 3 0
0 0 0 0 0 0 3 3 3 3 1 1 1 1 1 3 3 3 0 0 3 3 3 3 1 1 1 1 3 3 3 3 0
0 0 0 0 0 3 3 3 3 1 1 5 5 5 1 1 3 3 0 0 3 3 3 1 1 5 5 1 3 3 3 3 0
0 0 0 0 0 3 3 3 1 1 5 5 5 5 5 1 3 3 0 0 3 3 1 1 5 5 5 1 1 3 3 3 0
0 0 0 0 3 3 3 1 1 5 5 5 5 5 5 1 3 3 0 0 3 3 1 5 5 5 5 5 1 3 3 3 0
0 0 0 0 3 3 3 1 5 5 5 5 5 5 1 1 3 3 3 0 3 3 1 5 5 5 5 5 1 1 3 3 0
0 0 0 3 3 3 1 1 5 5 5 5 5 1 1 1 3 3 3 3 3 3 1 1 5 5 5 5 5 1 3 3 0
0 0 0 3 3 3 1 5 5 5 5 5 1 1 1 1 1 3 3 3 3 3 1 1 5 5 5 5 5 1 3 3 0
0 0 0 3 3 1 1 5 5 5 5 1 1 1 1 1 1 1 1 1 1 1 1 1 5 5 5 5 5 1 3 3 0
0 0 3 3 3 1 5 5 5 5 5 1 1 1 1 1 5 5 5 5 5 1 1 5 5 5 5 5 5 1 3 3 0
0 0 3 3 3 1 5 5 5 5 1 1 1 1 1 5 5 5 5 5 5 5 5 5 5 5 5 5 5 1 3 3 0
0 3 3 3 1 1 5 5 5 5 1 1 1 1 5 5 5 5 5 5 5 5 5 5 5 5 5 5 5 1 3 3 0
0 3 3 3 1 5 5 5 5 5 1 6 6 1 1 5 5 5 5 5 5 5 5 5 5 5 5 5 1 1 3 3 0
0 3 3 1 1 5 5 5 5 5 2 6 6 1 1 5 5 5 5 5 5 5 5 5 5 5 5 1 1 3 3 3 0
0 3 3 1 5 5 5 5 5 5 1 6 6 6 1 1 5 5 5 1 1 1 1 1 1 1 1 1 3 3 3 3 0
0 3 3 1 5 5 5 5 5 5 1 6 6 6 6 1 1 2 1 1 1 1 1 1 1 1 1 3 3 3 3 0 0
0 3 3 1 5 5 5 5 5 5 1 6 6 6 6 6 6 6 6 1 1 1 1 1 1 1 1 3 3 3 0 0 0
0 3 3 1 1 5 5 5 5 1 1 1 6 6 6 6 6 6 6 6 6 6 1 1 1 1 1 3 3 0 0 0 0
0 3 3 3 1 5 5 5 1 1 1 1 1 6 6 6 6 6 6 6 6 6 6 1 1 1 1 3 3 3 0 0 0
0 3 3 3 1 1 1 1 1 1 1 1 1 1 1 1 6 6 6 6 6 6 6 1 1 1 1 3 3 3 0 0 0
0 3 3 3 1 1 1 1 1 1 1 1 1 1 1 1 1 1 1 6 6 6 6 1 1 1 1 3 3 3 0 0 0
0 3 3 3 1 1 1 5 1 1 1 5 5 1 1 1 1 1 1 1 1 2 1 1 1 1 1 3 3 3 0 0 0
0 3 3 1 1 5 5 5 5 5 5 5 5 1 1 1 1 1 1 1 5 5 5 1 1 1 3 3 3 3 0 0 0
0 3 3 1 5 5 5 5 5 5 5 5 5 1 1 1 1 1 1 5 5 5 5 5 1 1 3 3 3 3 0 0 0
0 3 3 1 1 5 5 5 5 5 5 5 5 5 1 1 1 1 5 5 5 5 5 5 5 1 1 3 3 3 3 0 0
0 3 3 3 1 1 5 5 5 5 5 5 5 5 1 1 1 5 5 5 5 5 5 5 5 5 1 1 3 3 3 3 0
0 3 3 3 3 1 1 5 5 5 5 5 5 5 5 1 1 5 5 5 5 5 5 5 5 5 5 1 1 3 3 3 0
0 0 3 3 3 3 1 1 5 5 5 5 5 5 5 5 5 5 5 5 5 5 5 5 5 5 5 5 1 1 3 3 0
0 0 0 3 3 3 3 1 1 5 5 5 5 5 5 5 5 5 5 5 5 5 5 5 5 5 5 5 5 1 3 3 0
0 0 0 0 3 3 3 3 1 1 5 5 5 5 5 5 5 5 5 5 5 5 5 5 5 5 5 5 5 1 3 3 0
0 0 0 0 0 3 3 3 3 1 1 5 5 5 5 5 5 5 1 1 1 5 5 5 5 5 5 5 5 1 3 3 0
0 0 0 0 0 0 3 3 3 3 1 1 5 5 5 5 1 1 1 1 1 1 5 5 5 5 5 5 1 1 3 3 0
0 0 0 0 0 0 0 3 3 3 3 1 1 1 1 1 1 1 1 1 1 1 1 5 5 5 5 1 1 3 3 3 0
0 0 0 0 0 0 0 0 3 3 3 3 3 3 3 3 3 3 3 3 3 3 1 1 1 1 1 1 3 3 3 3 0
0 0 0 0 0 0 0 0 0 3 3 3 3 3 3 3 3 3 3 3 3 3 3 3 3 3 3 3 3 3 3 0 0
0 0 0 0 0 0 0 0 0 0 0 0 0 0 0 0 0 0 0 0 3 3 3 3 3 3 3 3 3 3 0 0 0
0 0 0 0 0 0 0 0 0 0 0 0 0 0 0 0 0 0 0 0 0 0 0 0 0 0 0 0 0 0 0 0 0
2
0 17 24 1 7 10
0