25 29
0 0 0 0 0 0 0 0 0 0 0 0 0 0 0 0 0 0 0 0 0 0 0 0 0 0 0 0 0
0 0 0 0 0 0 0 0 0 0 0 3 3 3 3 3 3 3 3 3 3 0 0 0 0 0 0 0 0
0 0 0 0 0 0 0 0 3 3 3 3 3 3 3 3 3 3 3 3 3 3 0 0 0 0 0 0 0
0 0 0 0 0 0 3 3 3 3 3 3 3 1 1 1 1 1 1 3 3 3 3 0 0 0 0 0 0
0 0 0 0 0 3 3 3 3 3 1 1 1 1 5 5 5 5 1 1 3 3 3 0 0 0 0 0 0
0 0 0 0 3 3 3 3 1 1 1 5 5 5 5 5 5 5 5 1 1 3 3 0 0 0 0 0 0
0 0 0 3 3 3 3 1 1 5 5 5 5 5 5 5 5 5 5 5 1 3 3 0 0 0 0 0 0
0 0 3 3 3 3 1 1 5 5 5 5 5 5 5 5 5 5 5 5 1 3 3 3 0 0 0 0 0
0 0 3 3 3 1 1 5 5 5 5 5 5 5 5 5 5 5 5 5 1 3 3 3 3 0 0 0 0
0 3 3 3 1 1 5 5 5 5 5 5 5 5 5 5 5 5 5 1 1 1 3 3 3 3 0 0 0
0 3 3 3 1 5 5 5 5 5 5 5 5 5 5 5 5 1 1 1 6 6 6 3 3 3 3 0 0
0 3 3 1 1 5 5 5 5 5 5 5 5 5 5 5 1 1 6 6 6 6 6 6 3 3 3 3 0
0 3 3 1 5 5 5 5 5 5 5 5 5 5 5 5 1 6 6 6 6 6 6 6 6 3 3 3 0
0 3 3 1 5 5 5 5 5 5 5 5 5 5 5 5 2 6 6 6 6 6 6 6 6 6 3 3 0
0 3 3 1 5 5 5 5 5 5 5 5 5 5 5 5 1 6 6 6 6 6 6 6 6 6 3 3 0
0 3 3 1 5 5 5 5 5 5 5 5 5 5 5 5 1 1 6 6 6 6 6 6 6 6 3 3 0
0 3 3 1 1 5 5 5 5 5 5 5 5 5 5 5 5 1 6 6 6 6 6 6 6 6 3 3 0
0 3 3 3 1 5 5 5 5 5 5 5 5 5 5 5 5 1 6 6 6 6 6 6 6 3 3 3 0
0 3 3 3 1 1 5 5 5 5 5 5 5 5 5 5 5 1 1 6 6 6 6 3 3 3 3 3 0
0 0 3 3 3 1 1 5 5 5 5 5 5 5 5 5 1 1 3 3 3 3 3 3 3 3 3 0 0
0 0 3 3 3 3 1 1 1 5 5 5 5 5 5 1 1 3 3 3 3 3 3 3 3 0 0 0 0
0 0 0 3 3 3 3 3 1 1 1 1 1 1 1 1 3 3 3 3 0 0 0 0 0 0 0 0 0
0 0 0 0 3 3 3 3 3 3 3 3 3 3 3 3 3 3 3 0 0 0 0 0 0 0 0 0 0
0 0 0 0 0 0 3 3 3 3 3 3 3 3 3 3 3 3 0 0 0 0 0 0 0 0 0 0 0
0 0 0 0 0 0 0 0 0 0 0 0 0 0 0 0 0 0 0 0 0 0 0 0 0 0 0 0 0
2
1
0 9 9
3
5 19 9
5 7 19
6 14 23
1
0 15 20
3
3 4 14
5 14 4
5 16 16