52 32
0 0 0 0 0 0 0 0 0 0 0 0 0 0 0 0 0 0 0 0 0 0 0 0 0 0 0 0 0 0 0 0
0 0 3 3 3 3 3 3 3 3 3 0 0 0 0 0 0 0 0 0 0 0 0 0 0 0 0 0 0 0 0 0
0 0 3 3 3 3 3 3 3 3 3 3 0 0 0 0 0 0 0 0 0 0 0 0 0 0 0 0 0 0 0 0
0 3 3 3 1 1 1 1 1 3 3 3 3 0 0 0 0 0 0 0 0 0 0 0 0 0 0 0 0 0 0 0
0 3 3 3 1 5 5 5 1 1 3 3 3 0 0 0 0 0 0 0 0 0 0 0 0 0 0 0 0 0 0 0
0 3 3 1 1 5 5 5 5 1 1 3 3 0 0 0 0 0 0 0 0 3 3 3 3 3 3 3 3 3 0 0
0 3 3 1 5 5 5 5 5 5 1 3 3 0 0 0 0 0 0 0 3 3 3 3 3 3 3 3 3 3 3 0
0 3 3 1 5 5 5 5 5 5 1 3 3 0 0 0 0 0 3 3 3 3 3 3 1 1 1 1 3 3 3 0
0 3 3 1 5 5 5 5 5 5 1 3 3 0 0 0 0 0 3 3 3 3 1 1 1 5 5 1 1 3 3 0
0 3 3 1 5 5 5 5 5 5 1 3 3 3 0 0 0 3 3 3 1 1 1 1 5 5 5 5 1 3 3 0
0 3 3 1 5 5 5 5 5 5 1 1 3 3 3 0 0 3 3 3 1 1 1 5 5 5 5 5 1 3 3 0
0 3 3 1 1 5 5 5 5 5 1 1 1 3 3 0 3 3 3 1 1 5 5 5 5 5 5 5 1 3 3 0
0 3 3 3 1 5 5 5 5 5 5 1 1 3 3 3 3 3 3 1 1 5 5 5 5 5 5 5 1 3 3 0
0 3 3 3 1 1 5 5 5 5 5 5 1 1 3 3 3 3 1 1 1 5 5 5 5 5 5 1 1 3 3 0
0 0 3 3 3 1 5 5 5 5 5 5 1 1 1 1 1 1 1 1 5 5 5 5 5 1 1 1 3 3 3 0
0 0 3 3 3 1 1 5 5 5 5 5 5 1 1 1 1 1 5 5 5 5 5 5 1 1 3 3 3 3 3 0
0 0 0 3 3 3 1 1 5 5 5 5 5 5 1 1 1 5 5 5 5 5 5 1 1 3 3 3 3 3 0 0
0 0 0 3 3 3 3 1 1 1 5 5 5 5 1 1 1 5 5 5 5 5 1 1 3 3 3 3 0 0 0 0
0 0 0 0 3 3 3 3 3 1 5 5 5 5 5 1 1 5 5 5 5 1 1 3 3 3 3 0 0 0 0 0
0 0 0 0 0 3 3 3 3 1 1 5 5 5 5 1 1 1 5 5 5 1 1 3 3 3 0 0 0 0 0 0
0 0 0 0 0 0 0 3 3 3 1 5 5 5 5 1 1 1 5 5 5 5 1 3 3 3 0 0 0 0 0 0
0 0 0 0 0 0 0 3 3 3 1 1 5 5 5 5 1 1 1 5 5 5 1 3 3 3 3 0 0 0 0 0
0 0 0 0 0 0 0 0 3 3 3 1 5 5 5 5 1 1 1 5 5 5 1 1 3 3 3 3 0 0 0 0
0 0 0 0 0 0 0 0 3 3 3 1 1 5 5 5 1 1 1 5 5 5 5 1 1 3 3 3 0 0 0 0
0 0 0 0 0 0 0 0 0 3 3 3 1 5 5 5 5 1 1 1 5 5 5 5 1 1 3 3 0 0 0 0
0 0 0 0 0 0 0 0 0 3 3 3 1 5 5 5 5 1 1 1 5 5 5 5 5 1 3 3 0 0 0 0
0 0 0 0 0 0 0 0 0 0 3 3 1 1 5 5 5 5 1 1 1 5 5 5 5 1 3 3 0 0 0 0
0 0 0 0 0 0 0 0 0 0 3 3 3 1 5 5 5 5 1 1 1 5 5 5 5 1 3 3 0 0 0 0
0 0 0 0 0 0 0 0 0 0 3 3 3 1 5 5 5 5 1 1 5 5 5 5 5 1 3 3 0 0 0 0
0 0 0 0 0 0 0 0 0 0 0 3 3 1 5 5 5 5 1 1 5 5 5 5 1 1 3 3 0 0 0 0
0 0 0 0 0 0 0 0 0 0 3 3 3 1 5 5 5 5 1 1 5 5 5 5 1 3 3 3 0 0 0 0
0 0 0 0 0 0 0 0 0 0 3 3 3 1 5 5 5 5 1 1 5 5 5 1 1 3 3 3 0 0 0 0
0 0 0 0 0 0 0 0 0 3 3 3 1 1 5 5 5 1 1 1 5 5 5 1 1 3 3 0 0 0 0 0
0 0 0 0 0 0 0 0 3 3 3 3 1 5 5 5 5 1 1 1 5 5 5 1 1 3 3 3 0 0 0 0
0 0 0 0 0 0 0 3 3 3 3 1 1 5 5 5 5 1 1 1 5 5 5 5 1 3 3 3 0 0 0 0
0 0 0 0 0 0 0 3 3 3 1 1 5 5 5 5 5 1 1 1 1 5 5 5 1 1 3 3 0 0 0 0
0 0 0 0 0 0 0 3 3 1 1 5 5 5 5 5 5 1 1 1 1 5 5 5 5 1 3 3 0 0 0 0
0 0 0 0 0 0 0 3 3 1 5 5 5 5 5 5 5 1 1 1 1 1 5 5 5 1 3 3 3 0 0 0
0 0 0 0 0 0 0 3 3 1 5 5 5 5 5 5 1 1 1 1 1 1 5 5 5 1 3 3 3 3 0 0
0 0 0 0 0 0 0 3 3 1 5 5 5 5 5 5 1 1 1 1 1 5 5 5 5 1 1 3 3 3 3 0
0 0 0 0 0 0 0 3 3 1 5 5 5 5 5 5 1 1 1 1 1 5 5 5 5 5 1 1 3 3 3 0
0 0 0 0 0 0 0 3 3 1 1 5 5 5 5 1 1 1 1 1 1 5 5 5 5 5 5 1 1 3 3 0
0 0 0 0 0 0 0 3 3 3 1 5 5 5 1 1 1 1 1 1 1 5 5 5 5 5 5 5 1 3 3 0
0 0 0 0 0 0 0 3 3 3 1 1 1 1 1 1 3 3 1 1 1 5 5 5 5 5 5 5 1 3 3 0
0 0 0 0 0 0 0 0 3 3 3 3 3 1 1 3 3 3 3 1 1 5 5 5 5 5 5 5 1 3 3 0
0 0 0 0 0 0 0 0 3 3 3 3 3 3 3 3 3 3 3 1 1 1 5 5 5 5 5 5 1 3 3 0
0 0 0 0 0 0 0 0 0 0 0 3 3 3 3 3 3 3 3 3 3 1 5 5 5 5 1 1 1 3 3 0
0 0 0 0 0 0 0 0 0 0 0 0 0 0 0 0 0 3 3 3 3 1 1 5 5 5 1 3 3 3 3 0
0 0 0 0 0 0 0 0 0 0 0 0 0 0 0 0 0 0 0 3 3 3 1 1 1 1 1 3 3 3 3 0
0 0 0 0 0 0 0 0 0 0 0 0 0 0 0 0 0 0 0 3 3 3 3 3 3 3 3 3 3 0 0 0
0 0 0 0 0 0 0 0 0 0 0 0 0 0 0 0 0 0 0 0 3 3 3 3 3 3 3 3 3 0 0 0
0 0 0 0 0 0 0 0 0 0 0 0 0 0 0 0 0 0 0 0 0 0 0 0 0 0 0 0 0 0 0 0
2
0 15 12 0 39 21
0