33 26
0 0 0 0 0 0 0 0 0 0 0 0 0 0 0 0 0 0 0 0 0 0 0 0 0 0
0 0 0 0 0 0 0 0 0 0 0 3 3 3 3 3 3 3 3 0 0 0 0 0 0 0
0 0 0 0 0 0 0 0 0 3 3 3 3 3 3 3 3 3 3 3 0 0 0 0 0 0
0 0 0 0 0 0 0 0 0 3 3 3 3 6 6 6 6 3 3 3 0 0 0 0 0 0
0 0 0 0 0 0 0 0 3 3 3 6 6 6 6 6 6 6 3 3 3 0 0 0 0 0
0 0 0 0 0 0 0 0 3 3 3 6 6 6 6 6 6 6 3 3 3 0 0 0 0 0
0 0 0 3 3 3 3 3 3 3 6 6 6 6 6 6 6 6 6 3 3 3 3 3 0 0
0 0 0 3 3 3 3 3 3 3 6 6 6 6 6 6 6 6 6 3 3 3 3 3 0 0
0 0 3 3 3 3 1 1 1 1 1 1 1 1 6 6 6 1 1 1 1 1 3 3 0 0
0 0 3 3 3 3 1 1 1 5 5 5 5 1 1 2 1 1 5 5 1 1 3 3 0 0
0 0 3 3 3 1 1 1 5 5 5 5 5 5 5 5 5 5 5 5 1 1 3 3 3 0
0 3 3 3 3 1 1 1 5 5 5 5 5 5 5 5 5 5 5 5 5 1 3 3 3 0
0 3 3 3 1 1 1 5 5 5 5 5 5 5 5 5 5 5 5 5 5 1 3 3 3 0
0 3 3 1 1 1 1 5 5 5 5 5 5 5 5 5 5 5 5 5 5 1 1 3 3 0
0 3 3 1 1 1 5 5 5 5 5 5 5 5 1 1 1 5 5 5 5 1 1 3 3 0
0 3 3 1 1 5 5 5 5 5 5 5 5 1 1 1 1 1 5 5 5 5 1 3 3 0
0 3 3 1 1 5 5 5 5 5 5 1 1 1 1 1 1 1 5 5 5 5 1 3 3 0
0 3 3 1 5 5 5 5 5 5 1 1 1 1 1 1 1 1 5 5 5 5 1 3 3 0
0 3 3 1 5 5 5 5 5 1 1 1 1 1 1 1 1 1 5 5 5 5 1 3 3 0
0 3 3 1 5 5 5 5 5 1 1 1 1 1 1 1 1 1 5 5 5 5 1 3 3 0
0 3 3 1 5 5 5 5 5 5 1 1 1 1 1 1 1 5 5 5 5 5 1 3 3 0
0 3 3 1 5 5 5 5 5 5 1 1 1 1 1 1 5 5 5 5 5 5 1 3 3 0
0 3 3 1 5 5 5 5 5 5 5 5 1 1 5 5 5 5 5 5 5 1 1 3 3 0
0 3 3 1 5 5 5 5 5 5 5 5 5 5 5 5 5 5 5 5 5 1 3 3 3 0
0 3 3 1 5 5 5 5 5 5 5 5 5 5 5 5 5 5 5 5 5 1 3 3 3 0
0 3 3 1 5 5 5 5 5 5 5 5 5 5 5 5 5 5 5 5 1 1 3 3 3 0
0 3 3 1 1 1 5 5 5 5 5 5 5 5 5 5 5 5 5 1 1 1 3 3 3 0
0 3 3 3 3 1 1 5 5 5 5 5 5 5 5 5 5 1 1 1 3 3 3 3 0 0
0 3 3 3 3 1 1 1 1 5 5 5 5 5 1 1 1 1 1 3 3 3 3 3 0 0
0 3 3 3 3 3 3 3 1 1 1 1 1 1 1 3 3 3 3 3 3 3 3 3 0 0
0 0 0 3 3 3 3 3 3 3 3 3 3 3 3 3 3 3 3 3 3 3 0 0 0 0
0 0 0 0 3 3 3 3 3 3 3 3 3 3 3 3 3 3 3 3 3 0 0 0 0 0
0 0 0 0 0 0 0 0 0 0 0 0 0 0 0 0 0 0 0 0 0 0 0 0 0 0
2
0 18 12 0 4 14
0