27 33
0 0 0 0 0 0 0 0 0 0 0 0 0 0 0 0 0 0 0 0 0 0 0 0 0 0 0 0 0 0 0 0 0
0 0 0 0 0 3 3 3 3 3 3 3 3 3 0 0 0 0 0 0 0 0 0 0 0 0 0 0 0 0 0 0 0
0 0 0 3 3 3 3 3 3 3 3 3 3 3 3 0 0 0 0 0 0 0 0 0 0 0 0 0 0 0 0 0 0
0 0 3 3 3 3 3 1 1 1 1 1 3 3 3 3 0 0 0 0 0 0 0 0 0 0 0 0 0 0 0 0 0
0 0 3 3 3 1 1 1 5 5 5 1 1 3 3 3 0 0 0 0 0 0 0 0 0 0 0 0 0 0 0 0 0
0 3 3 3 1 1 1 5 5 5 5 5 1 1 3 3 0 0 0 0 3 3 3 3 3 3 3 3 3 0 0 0 0
0 3 3 3 1 1 5 5 5 5 5 5 5 1 3 3 0 0 0 0 3 3 3 3 3 3 3 3 3 3 0 0 0
0 3 3 1 1 5 5 5 5 5 5 5 5 1 3 3 3 3 3 3 3 3 1 1 1 1 1 3 3 3 3 0 0
0 3 3 1 1 5 5 5 5 5 5 5 5 1 1 3 3 3 3 3 3 3 1 5 5 5 1 1 3 3 3 3 0
0 3 3 1 1 1 5 5 5 5 5 5 5 1 1 1 1 3 3 3 1 1 1 5 5 5 5 1 1 3 3 3 0
0 3 3 3 1 1 5 5 5 5 5 5 5 1 6 6 6 6 6 6 1 1 5 5 5 5 5 5 1 1 3 3 0
0 3 3 3 1 1 5 5 5 5 5 5 5 2 6 6 6 6 6 6 6 1 5 5 5 5 5 5 5 1 3 3 0
0 0 3 3 1 1 5 5 5 5 5 5 5 1 1 6 6 6 6 6 6 2 5 5 5 5 5 5 1 1 3 3 0
0 0 3 3 1 1 1 5 5 5 5 5 5 1 1 1 3 3 3 6 6 1 5 5 5 5 5 5 1 1 3 3 0
0 0 3 3 1 1 1 5 5 5 5 5 5 1 1 3 3 3 3 3 1 1 5 5 5 5 5 1 1 3 3 3 0
0 0 3 3 1 1 5 5 5 5 5 1 1 1 1 3 3 3 3 3 1 1 5 5 5 5 5 1 1 3 3 3 0
0 0 3 3 1 1 5 5 5 5 5 1 1 3 3 3 3 0 3 3 1 1 5 5 5 5 5 1 1 3 3 0 0
0 0 3 3 3 1 1 1 5 5 1 1 3 3 3 3 3 0 3 3 3 1 5 5 5 5 5 5 1 3 3 3 0
0 0 3 3 3 3 3 1 1 1 1 3 3 3 3 3 0 0 3 3 3 1 1 5 5 5 5 5 1 3 3 3 0
0 0 0 3 3 3 3 3 3 3 3 3 3 3 0 0 0 0 3 3 1 1 1 5 5 5 5 5 1 1 3 3 0
0 0 0 0 0 3 3 3 3 3 3 3 3 0 0 0 0 0 3 3 1 5 5 5 5 5 5 5 5 1 3 3 0
0 0 0 0 0 0 0 0 0 0 0 0 0 0 0 0 0 0 3 3 1 1 5 5 5 5 5 5 1 1 3 3 0
0 0 0 0 0 0 0 0 0 0 0 0 0 0 0 0 0 0 3 3 3 1 1 1 5 5 1 1 1 3 3 3 0
0 0 0 0 0 0 0 0 0 0 0 0 0 0 0 0 0 0 3 3 3 3 3 1 1 1 1 3 3 3 3 3 0
0 0 0 0 0 0 0 0 0 0 0 0 0 0 0 0 0 0 0 0 3 3 3 3 3 3 3 3 3 3 3 0 0
0 0 0 0 0 0 0 0 0 0 0 0 0 0 0 0 0 0 0 0 0 3 3 3 3 3 3 3 3 0 0 0 0
0 0 0 0 0 0 0 0 0 0 0 0 0 0 0 0 0 0 0 0 0 0 0 0 0 0 0 0 0 0 0 0 0
2
1
0 13 8
2
6 6 9
6 19 25
2
2 10 23 5 1
2 8 11 5 1
1
0 17 27
11
5 14 28
5 15 20
5 7 14
5 15 12
5 15 4
5 8 3
5 3 5
5 4 10
5 15 10
5 8 25
5 20 22
0
