16 16
0 0 0 0 0 0 0 0 0 0 0 0 0 0 0 0
0 0 0 0 0 3 3 3 3 3 3 3 0 0 0 0
0 0 3 3 3 3 3 3 3 3 3 3 3 3 0 0
0 3 3 3 3 3 3 1 1 1 3 3 3 3 0 0
0 3 3 3 1 1 1 1 1 1 1 1 3 3 3 0
0 3 3 1 1 1 5 5 5 5 1 1 3 3 3 0
0 3 3 1 1 5 5 5 5 5 5 1 3 3 3 0
0 3 3 1 1 5 5 5 5 5 5 1 1 3 3 0
0 3 3 1 5 5 5 5 5 5 5 1 1 3 3 0
0 3 3 1 5 5 5 5 5 5 1 1 1 3 3 0
0 3 3 1 1 1 5 5 5 5 1 1 3 3 3 0
0 3 3 3 3 1 5 5 5 1 1 1 3 3 3 0
0 3 3 3 3 1 1 1 1 1 3 3 3 3 3 0
0 0 3 3 3 3 3 3 3 3 3 3 3 3 0 0
0 0 0 3 3 3 3 3 3 3 3 3 0 0 0 0
0 0 0 0 0 0 0 0 0 0 0 0 0 0 0 0
2
1
0 5 6
1
5 5 9
0
1
0 5 7
1
5 5 6
1
6 10 6