33 26
0 0 0 0 0 0 0 0 0 0 0 0 0 0 0 0 0 0 0 0 0 0 0 0 0 0
0 0 0 0 0 0 0 0 0 0 0 3 3 3 3 3 3 3 3 0 0 0 0 0 0 0
0 0 0 0 0 0 0 0 0 3 3 3 3 3 3 3 3 3 3 3 0 0 0 0 0 0
0 0 0 0 0 0 0 0 0 3 3 3 3 6 6 6 6 3 3 3 0 0 0 0 0 0
0 0 0 0 0 0 0 0 3 3 3 6 6 6 6 6 6 6 3 3 3 0 0 0 0 0
0 0 0 0 0 0 0 0 3 3 3 6 6 6 6 6 6 6 3 3 3 0 0 0 0 0
0 0 0 3 3 3 3 3 3 3 6 6 6 6 6 6 6 6 6 3 3 3 3 3 0 0
0 0 0 3 3 3 3 3 3 3 6 6 6 6 6 6 6 6 6 3 3 3 3 3 0 0
0 0 3 3 3 3 1 1 1 1 1 1 6 6 6 6 6 1 1 1 1 1 3 3 0 0
0 0 3 3 3 3 1 1 1 5 5 1 1 1 2 1 1 1 5 5 1 1 3 3 0 0
0 0 3 3 3 1 1 1 5 5 5 5 5 5 5 5 5 5 5 5 1 1 3 3 3 0
0 3 3 3 3 1 1 1 5 5 5 5 5 5 5 5 5 5 5 5 5 1 3 3 3 0
0 3 3 3 1 1 1 5 5 5 5 5 5 5 5 5 5 5 5 5 5 1 3 3 3 0
0 3 3 1 1 1 1 5 5 5 5 5 5 5 5 5 5 5 5 5 5 1 1 3 3 0
0 3 3 1 1 1 5 5 5 5 5 5 5 5 1 1 1 5 5 5 5 1 1 3 3 0
0 3 3 1 1 5 5 5 5 5 5 5 5 1 1 1 1 1 5 5 5 5 1 3 3 0
0 3 3 1 1 5 5 5 5 5 5 1 1 1 1 1 1 1 5 5 5 5 1 3 3 0
0 3 3 1 5 5 5 5 5 5 1 1 1 1 1 1 1 1 5 5 5 5 1 3 3 0
0 3 3 1 5 5 5 5 5 1 1 1 1 1 1 1 1 1 5 5 5 5 1 3 3 0
0 3 3 1 5 5 5 5 5 1 1 1 1 1 1 1 1 1 5 5 5 5 1 3 3 0
0 3 3 1 5 5 5 5 5 1 1 1 1 1 1 1 1 5 5 5 5 5 1 3 3 0
0 3 3 1 5 5 5 5 5 1 1 1 1 1 1 1 1 5 5 5 5 5 1 3 3 0
0 3 3 1 5 5 5 5 5 5 1 1 1 1 1 1 5 5 5 5 5 1 1 3 3 0
0 3 3 1 5 5 5 5 5 5 5 1 1 1 1 5 5 5 5 5 5 1 3 3 3 0
0 3 3 1 5 5 5 5 5 5 5 5 5 5 5 5 5 5 5 5 5 1 3 3 3 0
0 3 3 1 5 5 5 5 5 5 5 5 5 5 5 5 5 5 5 5 1 1 3 3 3 0
0 3 3 1 1 1 5 5 5 5 5 5 5 5 5 5 5 5 5 1 1 1 3 3 3 0
0 3 3 3 3 1 1 5 5 5 5 5 5 5 5 5 5 1 1 1 3 3 3 3 0 0
0 3 3 3 3 1 1 1 1 5 5 5 5 5 1 1 1 1 1 3 3 3 3 3 0 0
0 3 3 3 3 3 3 3 1 1 1 1 1 1 1 3 3 3 3 3 3 3 3 3 0 0
0 0 0 3 3 3 3 3 3 3 3 3 3 3 3 3 3 3 3 3 3 3 0 0 0 0
0 0 0 0 3 3 3 3 3 3 3 3 3 3 3 3 3 3 3 3 3 0 0 0 0 0
0 0 0 0 0 0 0 0 0 0 0 0 0 0 0 0 0 0 0 0 0 0 0 0 0 0
1
2
0 17 12
0 4 14
4
5 23 10
5 16 9
5 20 17
5 13 17