30 22
0 0 0 0 0 0 0 0 0 0 0 0 0 0 0 0 0 0 0 0 0 0
0 0 0 0 0 0 0 0 0 0 0 0 0 0 3 3 3 3 3 3 0 0
0 0 0 0 0 0 0 0 0 0 0 0 0 3 3 3 3 3 3 3 0 0
0 0 0 0 3 3 3 3 3 3 3 3 3 3 3 3 1 1 3 3 0 0
0 0 0 0 3 3 3 3 3 3 3 3 3 3 3 3 1 1 3 3 0 0
0 0 0 0 3 3 1 1 3 3 3 3 3 3 3 3 1 1 3 3 0 0
0 0 0 0 3 3 1 6 6 6 3 3 3 3 3 3 1 1 3 3 0 0
0 0 0 0 3 3 1 6 6 6 1 3 3 3 3 3 1 1 3 3 0 0
0 0 0 0 3 3 1 6 6 6 1 1 3 3 3 3 1 1 3 3 3 0
0 0 0 3 3 3 3 6 6 6 1 1 3 3 3 3 6 6 3 3 3 0
0 0 0 3 3 3 3 6 6 6 1 1 3 3 3 3 6 6 6 3 3 0
0 0 3 3 3 3 1 6 6 6 1 3 3 3 3 6 6 6 6 3 3 0
0 3 3 3 3 1 1 6 6 6 3 3 3 3 3 6 6 6 6 3 3 0
0 3 3 3 1 1 1 1 1 3 3 3 3 3 6 6 6 6 6 3 3 0
0 3 3 6 6 6 1 3 3 3 3 3 3 6 6 6 6 6 1 3 3 0
0 3 3 6 6 6 1 3 3 3 3 3 1 6 6 6 6 1 3 3 3 0
0 3 3 6 6 6 3 3 3 3 3 1 1 6 6 6 1 1 3 3 3 0
0 3 3 6 6 6 3 3 3 3 6 6 6 1 3 3 1 1 3 3 0 0
0 3 3 6 6 6 3 3 3 6 6 6 6 3 3 3 1 3 3 3 0 0
0 3 3 6 6 6 1 6 6 6 6 6 6 3 3 3 3 3 3 3 0 0
0 3 3 3 1 1 1 6 6 6 6 6 3 3 3 3 3 3 3 0 0 0
0 3 3 3 3 1 1 6 6 6 6 6 3 3 3 3 3 3 0 0 0 0
0 0 3 3 3 3 1 6 6 6 6 1 1 1 3 3 3 0 0 0 0 0
0 0 0 3 3 3 1 3 3 1 1 1 1 1 3 3 3 0 0 0 0 0
0 0 0 0 3 3 3 3 3 3 1 1 1 3 3 3 0 0 0 0 0 0
0 0 0 0 0 3 3 3 3 3 3 1 1 3 3 3 0 0 0 0 0 0
0 0 0 0 0 0 0 3 3 3 3 1 1 3 3 0 0 0 0 0 0 0
0 0 0 0 0 0 0 0 3 3 3 3 3 3 3 0 0 0 0 0 0 0
0 0 0 0 0 0 0 0 0 3 3 3 3 3 3 0 0 0 0 0 0 0
0 0 0 0 0 0 0 0 0 0 0 0 0 0 0 0 0 0 0 0 0 0
2
2
0 2 16
1 10 8
4
5 9 18
5 7 11
5 13 3
6 20 8
4
0 5 6
2 22 11 4 1
2 13 4 7 1
2 6 16 11 2
2
0 4 6
1 25 11
0
7
6 20 9
6 15 4
6 11 16
7 3 16
7 5 16
7 7 16
7 9 16