21 30
0 0 0 0 0 0 0 0 0 0 0 0 0 0 0 0 0 0 0 0 0 0 0 0 0 0 0 0 0 0
0 0 0 0 3 3 3 3 3 3 3 3 3 3 3 0 0 0 0 0 0 0 0 0 0 0 0 0 0 0
0 0 0 3 3 3 3 3 3 3 3 3 3 3 3 3 3 3 3 3 3 3 3 3 3 3 0 0 0 0
0 3 3 3 3 3 1 1 1 1 1 1 1 3 3 3 3 3 3 3 3 3 3 3 3 3 3 3 0 0
0 3 3 3 3 1 1 1 5 5 5 1 1 1 3 3 3 3 1 1 1 1 1 1 3 3 3 3 0 0
0 3 3 1 1 1 5 5 5 5 5 5 1 1 1 3 3 1 1 1 1 1 1 1 1 1 3 3 3 0
0 3 3 1 1 5 5 5 5 5 5 5 5 1 1 1 1 1 1 1 5 5 5 1 1 1 3 3 3 0
0 3 3 1 5 5 5 5 5 5 5 5 5 5 1 1 1 1 5 5 5 5 5 5 1 1 3 3 3 0
0 3 3 1 5 5 5 5 5 5 5 5 5 5 5 5 5 5 5 5 5 5 5 5 5 1 1 3 3 0
0 3 3 1 1 5 5 5 5 5 5 5 5 5 5 5 5 5 5 5 5 5 5 5 5 1 1 3 3 0
0 3 3 3 1 1 1 2 1 1 1 1 5 5 5 5 5 5 5 5 5 5 5 5 5 5 1 3 3 0
0 3 3 3 3 1 6 6 6 1 1 1 1 1 5 5 5 5 5 5 5 5 5 5 5 5 1 3 3 0
0 0 3 3 3 6 6 6 6 6 1 1 1 1 5 5 5 5 5 5 5 5 5 5 5 5 1 3 3 0
0 0 0 3 3 6 6 6 6 6 3 3 1 5 5 5 5 5 5 5 5 5 5 5 5 5 1 3 3 0
0 0 0 3 3 6 6 6 6 3 3 3 1 5 5 5 5 5 5 5 5 5 5 5 5 1 1 3 3 0
0 0 0 3 3 3 6 6 1 3 3 3 1 5 5 5 5 5 5 5 5 1 1 1 1 1 3 3 3 0
0 0 0 3 3 3 3 3 3 3 3 3 1 1 5 5 5 5 1 1 1 1 3 3 3 3 3 3 3 0
0 0 0 0 3 3 3 3 3 3 3 3 3 1 1 1 1 1 1 3 3 3 3 3 3 3 3 3 0 0
0 0 0 0 0 0 0 0 0 3 3 3 3 3 3 3 3 3 3 3 3 3 3 3 0 0 0 0 0 0
0 0 0 0 0 0 0 0 0 0 3 3 3 3 3 3 3 3 3 3 3 3 0 0 0 0 0 0 0 0
0 0 0 0 0 0 0 0 0 0 0 0 0 0 0 0 0 0 0 0 0 0 0 0 0 0 0 0 0 0
2
1
1 14 6
4
5 14 8
5 5 6
5 5 16
6 11 19
1
0 11 20
5
5 13 13
5 5 11
5 10 25
5 3 23
6 13 6