37 29
0 0 0 0 0 0 0 0 0 0 0 0 0 0 0 0 0 0 0 0 0 0 0 0 0 0 0 0 0
0 0 0 0 0 0 0 0 0 3 3 3 3 3 3 3 3 3 3 3 0 0 0 0 0 0 0 0 0
0 0 0 0 0 0 3 3 3 3 3 3 3 3 3 3 3 3 3 3 3 3 0 0 0 0 0 0 0
0 0 0 0 3 3 3 3 3 3 3 1 1 1 1 1 1 1 3 3 3 3 3 3 0 0 0 0 0
0 0 0 3 3 3 3 3 1 1 1 1 1 1 1 1 1 1 1 1 3 3 3 3 3 0 0 0 0
0 0 3 3 3 3 1 1 1 1 1 1 1 1 1 1 1 1 1 1 1 1 3 3 3 3 0 0 0
0 3 3 3 3 1 1 1 1 1 1 1 1 1 1 1 1 1 1 6 6 1 1 3 3 3 3 0 0
0 3 3 3 1 1 1 1 1 1 1 1 1 1 1 1 1 1 6 6 6 6 1 1 3 3 3 0 0
0 3 3 1 1 1 1 1 1 2 1 1 1 1 1 1 1 6 6 6 6 6 6 1 1 3 3 3 0
0 3 3 1 1 1 1 1 5 5 5 1 1 1 1 1 6 6 6 6 6 6 6 1 1 3 3 3 0
0 3 3 1 1 5 5 5 5 5 5 5 5 1 1 1 6 6 6 6 6 6 6 6 1 1 3 3 0
0 3 3 1 1 5 5 5 5 5 5 5 5 5 1 1 6 6 6 6 6 6 6 6 6 1 3 3 0
0 3 3 1 5 5 5 5 5 5 5 5 5 5 1 1 6 6 6 6 6 6 6 6 6 1 3 3 0
0 3 3 1 5 5 5 5 5 5 5 5 5 5 1 1 1 6 6 6 6 6 6 6 6 1 3 3 0
0 3 3 1 5 5 5 5 5 5 5 5 5 1 1 1 1 6 6 6 6 6 6 6 6 1 3 3 0
0 3 3 1 1 5 5 5 5 5 5 5 5 1 1 1 1 1 6 6 6 6 6 6 1 1 3 3 0
0 3 3 3 1 5 5 5 5 5 5 5 5 5 1 1 1 1 6 6 6 6 6 1 1 3 3 3 0
0 3 3 3 1 5 5 5 5 5 5 5 5 5 1 1 1 1 1 6 6 6 1 1 3 3 3 3 0
0 0 3 3 1 1 5 5 5 5 5 5 5 5 5 1 1 1 1 1 1 1 1 1 3 3 3 0 0
0 0 3 3 3 1 5 5 5 5 5 5 5 5 5 5 1 1 1 1 1 1 1 3 3 3 0 0 0
0 0 3 3 3 1 5 5 5 5 5 5 5 5 5 5 1 1 1 1 1 1 1 3 3 3 0 0 0
0 0 0 3 3 1 1 5 5 5 5 5 5 5 5 5 5 5 1 1 1 1 1 3 3 3 0 0 0
0 0 0 3 3 3 1 5 5 5 5 5 5 5 5 5 5 5 5 1 1 1 1 1 3 3 0 0 0
0 0 0 3 3 3 1 1 5 5 5 5 5 5 5 5 5 5 5 1 1 1 1 1 3 3 0 0 0
0 0 0 0 3 3 3 1 5 5 5 5 5 5 5 5 5 5 5 5 1 1 1 1 3 3 0 0 0
0 0 0 0 3 3 3 1 1 5 5 5 5 5 5 5 5 5 5 5 5 1 1 1 3 3 0 0 0
0 0 0 0 0 3 3 3 1 1 1 5 5 5 5 5 5 5 5 5 5 1 1 1 3 3 0 0 0
0 0 0 0 0 3 3 3 3 3 1 1 1 5 5 5 5 5 5 5 5 2 1 1 3 3 0 0 0
0 0 0 0 0 0 3 3 3 3 3 3 1 1 5 5 5 5 5 5 5 1 1 1 3 3 0 0 0
0 0 0 0 0 0 0 0 3 3 3 3 3 1 5 5 5 5 5 5 5 1 1 3 3 3 0 0 0
0 0 0 0 0 0 0 0 0 0 3 3 3 1 1 5 5 5 5 5 5 1 1 3 3 3 0 0 0
0 0 0 0 0 0 0 0 0 0 0 3 3 3 1 5 5 5 5 5 1 1 1 3 3 3 0 0 0
0 0 0 0 0 0 0 0 0 0 0 3 3 3 1 1 5 5 5 1 1 1 3 3 3 3 0 0 0
0 0 0 0 0 0 0 0 0 0 0 0 3 3 3 1 1 1 1 1 3 3 3 3 3 0 0 0 0
0 0 0 0 0 0 0 0 0 0 0 0 3 3 3 3 3 3 3 3 3 3 3 3 0 0 0 0 0
0 0 0 0 0 0 0 0 0 0 0 0 0 3 3 3 3 3 3 3 3 3 0 0 0 0 0 0 0
0 0 0 0 0 0 0 0 0 0 0 0 0 0 0 0 0 0 0 0 0 0 0 0 0 0 0 0 0
1
1
0 13 8
0