19 33
0 0 0 0 0 0 0 0 0 0 0 0 0 0 0 0 0 0 0 0 0 0 0 0 0 0 0 0 0 0 0 0 0
0 3 3 3 3 3 3 3 3 3 3 3 3 3 3 3 3 3 3 3 3 3 3 3 3 3 3 3 3 3 3 3 0
0 3 3 3 3 3 3 3 3 3 3 3 3 3 3 3 3 3 3 3 3 3 3 3 3 3 3 3 3 3 3 3 0
0 3 3 3 3 3 3 1 1 1 1 3 3 1 1 1 1 1 3 3 3 3 3 1 1 3 3 3 3 3 3 3 0
0 3 3 3 3 3 3 3 1 1 1 1 1 1 1 1 1 1 1 3 3 3 1 1 1 1 1 1 1 3 3 3 0
0 3 3 3 3 3 3 3 3 3 1 1 1 1 3 3 3 6 6 6 1 1 1 3 3 3 1 1 1 1 3 3 0
0 3 3 3 3 3 3 3 3 3 3 3 1 1 3 3 3 6 6 6 3 3 3 3 3 3 1 1 1 3 3 3 0
0 3 3 3 3 3 3 3 3 3 3 3 6 6 6 1 1 6 6 6 3 3 3 3 3 3 1 1 3 3 3 3 0
0 3 3 1 1 3 3 3 3 3 1 1 6 6 6 1 3 3 3 1 1 1 3 3 3 1 1 1 3 3 3 3 0
0 3 3 1 1 1 3 3 1 1 1 1 6 6 6 3 3 3 3 1 1 1 3 3 3 1 1 1 3 3 3 3 0
0 3 3 3 1 1 1 1 3 3 3 1 1 1 3 3 3 3 3 1 1 3 3 3 1 1 1 1 1 1 3 3 0
0 3 3 3 1 1 1 3 3 3 3 1 1 3 3 3 3 3 6 6 6 3 3 3 3 3 3 3 1 1 3 3 0
0 3 3 3 1 1 1 3 3 3 3 1 1 3 3 3 3 1 6 6 6 1 3 3 3 3 3 3 1 1 3 3 0
0 3 3 3 3 1 1 1 3 3 1 1 1 1 3 3 1 1 6 6 6 1 1 3 3 1 1 1 1 1 3 3 0
0 3 3 3 3 1 1 1 1 1 1 1 1 1 1 1 1 3 3 1 1 1 1 1 1 1 1 1 3 3 3 3 0
0 3 3 3 3 3 1 1 1 1 1 3 3 1 1 3 3 3 3 3 3 1 1 1 1 1 1 3 3 3 3 3 0
0 3 3 3 3 3 3 3 3 3 3 3 3 3 3 3 3 3 3 3 3 3 3 3 3 3 3 3 3 3 3 3 0
0 3 3 3 3 3 3 3 3 3 3 3 3 3 3 3 3 3 3 3 3 3 3 3 3 3 3 3 3 3 3 3 0
0 0 0 0 0 0 0 0 0 0 0 0 0 0 0 0 0 0 0 0 0 0 0 0 0 0 0 0 0 0 0 0 0
2
1
0 7 13
5
5 12 25
5 8 5
5 12 16
5 4 29
6 3 23
0
1
0 2 24
5
6 11 11
5 6 16
5 12 27
5 13 5
5 2 8
0
