13 12
0 0 0 0 0 0 0 0 0 0 0 0
0 3 3 3 3 3 3 3 3 3 3 0
0 3 3 3 3 3 3 3 3 3 3 0
0 3 3 1 1 1 1 1 1 3 3 0
0 3 3 1 5 5 5 5 1 3 3 0
0 3 3 1 5 5 5 5 1 3 3 0
0 3 3 1 5 5 5 5 1 3 3 0
0 3 3 1 5 5 5 5 1 3 3 0
0 3 3 1 5 5 5 5 1 3 3 0
0 3 3 1 1 1 1 1 1 3 3 0
0 3 3 3 3 3 3 3 3 3 3 0
0 3 3 3 3 3 3 3 3 3 3 0
0 0 0 0 0 0 0 0 0 0 0 0
1
1 6 5
0