33 36
0 0 0 0 0 0 0 0 0 0 0 0 0 0 0 0 0 0 0 0 0 0 0 0 0 0 0 0 0 0 0 0 0 0 0 0
0 0 0 0 3 3 3 3 3 3 3 3 3 3 0 0 0 0 0 0 0 0 0 0 0 0 0 0 0 0 0 0 0 0 0 0
0 0 0 3 3 3 3 3 3 3 3 3 3 3 3 3 3 3 0 0 0 0 0 3 3 3 3 3 0 0 0 0 0 0 0 0
0 0 3 3 3 3 1 1 1 1 1 1 3 3 3 3 3 3 0 0 3 3 3 3 3 3 3 3 3 0 0 0 0 0 0 0
0 0 3 3 3 1 1 5 5 5 5 1 1 1 3 3 3 0 3 3 3 3 3 3 3 3 3 3 3 3 0 0 0 0 0 0
0 3 3 3 1 1 5 5 5 5 5 5 5 1 1 3 3 3 3 3 3 1 1 1 1 1 3 3 3 3 0 0 0 0 0 0
0 3 3 3 1 5 5 5 5 5 5 5 5 1 1 3 3 3 3 3 1 1 1 4 1 1 1 3 3 3 3 0 0 0 0 0
0 3 3 1 1 5 5 5 5 5 5 5 5 1 1 3 3 3 3 1 1 1 5 5 5 1 1 1 3 3 3 0 0 0 0 0
0 3 3 1 5 5 5 5 5 5 5 5 1 1 1 1 3 3 1 1 1 5 5 5 5 5 1 1 3 3 3 0 0 0 0 0
0 3 3 1 5 5 5 5 5 5 5 1 1 1 1 1 1 1 1 1 5 5 5 5 5 5 5 1 1 3 3 3 0 0 0 0
0 3 3 1 5 5 5 5 5 5 5 1 1 1 1 1 1 1 5 5 5 5 5 5 5 5 5 1 1 3 3 3 0 0 0 0
0 3 3 1 5 5 1 1 5 5 5 5 1 1 1 5 5 5 5 5 5 5 5 5 5 5 5 1 1 3 3 3 0 0 0 0
0 3 3 1 5 5 1 1 5 5 5 5 5 5 5 5 5 5 5 5 5 5 5 1 1 5 5 1 1 1 3 3 0 0 0 0
0 3 3 1 1 5 1 1 5 5 5 5 5 5 5 5 5 5 5 5 5 5 5 1 1 5 5 5 1 1 3 3 3 0 0 0
0 3 3 1 1 1 1 1 1 5 5 5 5 5 5 5 5 5 5 5 5 5 5 5 5 5 5 5 1 1 1 3 3 3 0 0
0 3 3 3 1 1 1 1 1 5 5 5 5 5 5 5 5 5 1 1 5 5 5 5 5 5 5 5 1 1 1 1 3 3 3 0
0 3 3 3 3 1 1 1 5 5 5 5 5 5 5 5 1 1 1 1 1 5 5 5 5 5 5 5 5 1 1 1 3 3 3 0
0 0 3 3 3 1 1 5 5 5 5 5 5 5 5 5 1 1 1 1 1 1 1 5 5 5 5 5 5 5 5 1 1 3 3 0
0 0 0 3 3 1 1 5 5 5 5 5 5 5 5 1 1 1 1 6 6 1 1 1 1 1 5 5 5 5 5 5 1 3 3 0
0 0 0 3 3 1 5 5 5 5 5 5 5 5 5 1 1 3 3 6 6 6 6 3 3 1 1 5 5 5 5 5 1 3 3 0
0 0 3 3 3 1 5 5 5 5 5 5 5 5 5 5 1 3 3 6 6 6 6 3 3 3 1 5 5 5 5 5 1 3 3 0
0 0 3 3 3 1 5 5 5 5 5 5 5 5 5 1 1 1 1 6 6 6 3 3 3 3 1 5 5 5 5 1 1 3 3 0
0 0 3 3 1 1 5 5 5 5 5 5 5 5 1 1 1 1 6 6 6 3 3 3 3 3 1 1 2 1 1 1 3 3 3 0
0 0 3 3 1 1 5 5 5 5 5 1 1 1 1 3 3 1 6 6 6 3 3 3 3 1 6 6 6 6 1 3 3 3 0 0
0 0 3 3 1 1 1 5 5 5 1 1 3 3 3 3 3 1 6 6 6 3 3 3 3 6 6 6 6 6 3 3 3 0 0 0
0 0 3 3 3 1 1 1 1 1 1 1 3 3 3 3 3 3 1 6 6 6 3 3 1 6 6 6 6 1 3 3 3 0 0 0
0 0 3 3 3 3 1 1 1 1 3 3 3 3 3 3 3 3 1 6 6 6 6 6 6 6 6 6 6 3 3 3 0 0 0 0
0 0 0 3 3 3 3 3 3 3 3 3 3 3 0 0 3 3 3 1 6 6 6 6 6 6 6 6 1 3 3 3 0 0 0 0
0 0 0 0 3 3 3 3 3 3 3 3 0 0 0 0 3 3 3 3 1 6 6 6 6 6 6 1 3 3 3 3 0 0 0 0
0 0 0 0 0 0 0 0 0 0 0 0 0 0 0 0 0 3 3 3 3 1 6 6 6 6 1 3 3 3 3 0 0 0 0 0
0 0 0 0 0 0 0 0 0 0 0 0 0 0 0 0 0 0 3 3 3 3 3 3 3 3 3 3 3 3 0 0 0 0 0 0
0 0 0 0 0 0 0 0 0 0 0 0 0 0 0 0 0 0 0 3 3 3 3 3 3 3 3 3 3 0 0 0 0 0 0 0
0 0 0 0 0 0 0 0 0 0 0 0 0 0 0 0 0 0 0 0 0 0 0 0 0 0 0 0 0 0 0 0 0 0 0 0
2
1
0 11 15
7
5 12 5
5 4 25
5 19 6
5 24 21
5 14 30
6 8 14
6 18 19
2
0 6 11
5 17 26
1
0 20 17
8
5 17 17
5 25 6
5 14 6
5 13 30
5 4 7
5 8 21
5 23 7
6 16 14
2
4 18 10
6 12 25