33 37
0 0 0 0 0 0 0 0 0 0 0 0 0 0 0 0 0 0 0 0 0 0 0 0 0 0 0 0 0 0 0 0 0 0 0 0 0
0 0 0 0 0 0 0 0 3 3 3 3 3 3 3 3 3 3 0 0 0 0 0 0 0 0 0 0 0 0 0 0 0 0 0 0 0
0 0 0 0 0 0 0 3 3 3 3 3 3 3 3 3 3 3 3 0 0 0 0 0 0 0 0 0 0 0 0 0 0 0 0 0 0
0 0 0 0 0 0 3 3 3 3 1 6 6 6 6 1 3 3 3 3 0 0 0 0 0 0 0 0 0 0 0 0 0 0 0 0 0
0 0 0 0 0 3 3 3 3 1 6 6 6 6 6 6 1 3 3 3 3 0 0 0 0 3 3 3 3 3 3 3 3 3 3 0 0
0 0 0 0 0 3 3 3 1 6 6 6 6 6 6 6 6 1 3 3 3 0 0 3 3 3 3 3 3 3 3 3 3 3 3 3 0
0 0 0 0 0 3 3 3 6 6 6 6 6 6 6 6 6 6 1 3 3 3 0 3 3 3 3 1 1 1 1 1 1 3 3 3 0
0 0 0 0 3 3 3 1 6 6 6 6 1 3 3 6 6 6 1 3 3 3 3 3 3 1 1 1 1 5 5 5 1 1 3 3 0
0 0 0 3 3 3 3 6 6 6 6 6 3 3 3 3 6 6 6 1 3 3 3 3 3 1 1 5 5 5 5 5 5 1 3 3 0
0 0 3 3 3 3 1 6 6 6 6 1 3 3 3 3 6 6 6 1 3 3 3 3 1 1 5 5 5 5 5 5 5 1 3 3 0
0 3 3 3 3 1 1 1 2 1 1 3 3 3 3 3 6 6 6 3 3 3 3 3 1 5 5 5 5 5 5 5 5 1 3 3 0
0 3 3 3 1 1 5 5 5 5 1 3 3 3 3 6 6 6 1 3 3 3 3 1 1 5 5 5 5 5 5 5 1 1 3 3 0
0 3 3 1 1 5 5 5 5 5 1 3 3 3 6 6 6 6 3 3 3 3 3 1 1 5 5 5 5 5 5 1 1 3 3 3 0
0 3 3 1 5 5 5 5 5 5 1 1 3 3 6 6 6 6 3 3 3 3 1 1 5 5 5 5 5 5 5 1 3 3 3 3 0
0 3 3 1 5 5 5 5 5 5 5 1 1 1 1 4 1 1 3 3 3 3 1 5 5 5 5 5 5 5 1 1 3 3 3 0 0
0 3 3 1 1 1 5 5 5 5 5 5 5 5 5 5 5 1 1 3 3 1 1 5 5 5 5 5 5 5 1 1 3 3 3 0 0
0 3 3 3 1 1 1 1 5 5 5 5 5 5 5 5 5 5 1 1 1 5 5 5 5 5 5 5 5 5 1 1 3 3 3 3 0
0 3 3 3 3 1 1 1 1 5 5 5 5 5 5 5 5 5 5 5 5 5 5 5 5 5 5 5 5 5 5 1 1 3 3 3 0
0 0 3 3 3 3 1 1 1 5 5 5 5 5 5 5 5 5 5 5 5 5 5 5 5 5 5 5 5 5 5 1 1 1 3 3 0
0 0 0 3 3 3 3 1 1 5 5 5 5 5 5 5 5 5 5 5 5 5 5 5 5 5 5 5 5 5 5 5 1 1 3 3 0
0 0 0 0 3 3 3 1 1 5 5 5 5 5 5 5 5 5 5 5 5 5 5 5 1 1 5 5 5 5 5 5 5 1 3 3 0
0 0 0 0 0 3 3 1 1 1 5 5 5 5 5 5 5 5 5 5 5 5 1 1 1 1 5 5 5 5 5 5 5 1 3 3 0
0 0 0 0 0 3 3 3 1 1 5 5 5 5 5 5 5 5 5 1 1 1 1 1 1 1 1 5 5 5 5 5 5 1 3 3 0
0 0 0 0 0 3 3 3 1 1 5 5 5 5 5 5 5 1 1 1 1 1 1 1 1 1 1 5 5 5 5 5 5 1 3 3 0
0 0 0 0 0 3 3 3 3 1 1 5 5 5 5 5 1 1 1 3 3 1 1 1 1 5 5 5 5 5 5 5 1 1 3 3 0
0 0 0 0 0 0 3 3 3 1 1 1 5 5 5 1 1 1 3 3 3 3 1 1 5 5 5 5 5 5 5 5 1 1 3 3 0
0 0 0 0 0 0 3 3 3 3 1 1 1 1 1 1 1 3 3 3 3 3 1 1 5 5 5 5 5 5 5 5 1 3 3 3 0
0 0 0 0 0 0 0 3 3 3 3 1 1 1 1 3 3 3 3 3 3 3 1 1 5 5 5 5 5 5 5 1 1 3 3 3 0
0 0 0 0 0 0 0 3 3 3 3 3 3 3 3 3 3 3 3 0 3 3 3 1 1 1 5 5 5 5 1 1 3 3 3 0 0
0 0 0 0 0 0 0 0 3 3 3 3 3 3 3 3 3 0 0 3 3 3 3 3 3 1 1 1 1 1 1 3 3 3 3 0 0
0 0 0 0 0 0 0 0 0 3 3 3 3 3 0 0 0 0 0 3 3 3 3 3 3 3 3 3 3 3 3 3 3 3 0 0 0
0 0 0 0 0 0 0 0 0 0 0 0 0 0 0 0 0 0 0 0 0 0 0 3 3 3 3 3 3 3 3 3 3 0 0 0 0
0 0 0 0 0 0 0 0 0 0 0 0 0 0 0 0 0 0 0 0 0 0 0 0 0 0 0 0 0 0 0 0 0 0 0 0 0
3
1
0 12 15
8
5 7 30 
5 25 24
5 24 25
5 24 26
5 11 6
5 15 4
5 25 16
6 24 13
3
3 18 9 21 4
3 16 23 6 1
3 20 10 11 1
1
0 24 26
8
5 11 6
5 10 25
5 8 28
5 12 30
5 3 16
5 11 14
5 27 29
6 23 21
8
7 21 11
7 16 11
7 21 15
7 23 12
7 16 15
7 18 9
7 19 13
7 18 19
1
0 11 6
7
5 19 23
5 16 21
5 21 18
5 22 10
5 12 17
5 26 11
5 17 6
1
1 18 17